abandon		n. 狂热；放任;vt. 遗弃；放弃
ability		n. 能力，能耐；才能
abnormal		adj. 反常的，不规则的；变态的
abnormally		adv. 反常地；变态地；不规则地
Absence		n. 没有；缺乏；缺席；不注意
absolutely		adv. 绝对地；完全地
Absorb		vt. 吸收；吸引；承受；理解；使…全神贯注
Abstract		n. 摘要；抽象；抽象的概念;adj. 抽象的；深奥的;vt. 摘要；提取；使……抽象化;vi. 做摘要；写梗概
abundant		adj. 丰富的；充裕的；盛产
Abuse		n. 滥用；虐待；辱骂；弊端；恶习，陋习;n. (Abuse)人名；(英)阿比斯;vt. 滥用；虐待；辱骂
academic		n. 大学生，大学教师；学者;adj. 学术的；理论的；学院的
Academy		n. 学院；研究院；学会；专科院校
Accelerate		vt. 使……加快；使……增速;vi. 加速；促进；增加
Accept		vt. 接受；承认；承担；承兑；容纳;vi. 承认；同意；承兑
Acceptability		n. 可接受性；可容许性
Acceptance		验收
Access		n. 进入；使用权；通路;vt. 使用；存取；接近
accessible		adj. 易接近的；可进入的；可理解的
accident		n. 事故；意外；[法] 意外事件；机遇
accommodate		vi. 适应；调解;vt. 容纳；使适应；供应；调解
accommodation		n. 住处，膳宿；调节；和解；预订铺位
accompany		vt. 陪伴，伴随；伴奏;vi. 伴奏，伴唱
accomplish		vt. 完成；实现；达到
accomplishment		n. 成就；完成；技艺，技能
according to		根据，按照；取决于；据…所说
Account		n. 账户；解释；账目，账单；理由;vt. 认为；把…视为;vi. 解释；导致；报账
account for		对…负有责任；对…做出解释；说明……的原因；导致；（比例）占
Accumulate		vt. 积攒;vi. 累积；积聚
Accuracy		n. [数] 精确度，准确性
Accurate		adj. 精确的
Accurately		adv. 精确地，准确地
Achieve		vt. 达到；完成;vi. 达到目的；如愿以偿
Achievement		n. 成就；完成；达到
Acid		n. 酸；<俚>迷幻药;adj. 酸的；讽刺的；刻薄的
Acknowledge		vt. 承认；答谢；报偿；告知已收到
Acquire		vt. 获得；取得；学到；捕获
Action		n. 行动；活动；功能；战斗；情节;n. (Action)人名；(英)埃克申
Activate		vt. 刺激；使活动；使活泼；使产生放射性;vi. 激活；有活力
Active		n. 主动语态；积极分子;adj. 积极的；活跃的；主动的；有效的；现役的
activity		n. 活动；行动；活跃
Actual		adj. 真实的，实际的；现行的，目前的
Actually		adv. 实际上；事实上
adage		n. 格言，谚语；箴言
Adapt		vt. 使适应；改编;vi. 适应
Adaptable		adj. 适合的；能适应的；可修改的
Adaptive		adj. 适应的，适合的
Add		n. 加法，加法运算;vt. 增加，添加；补充说；计算…总和;vi. 加；增加；加起来；做加法
addition		n. 添加；[数] 加法；增加物
Additional		adj. 附加的，额外的
Address		n. 地址；演讲；致辞；说话的技巧;vt. 演说；从事；忙于；写姓名地址；向…致辞
adequate		adj. 充足的；适当的；胜任的
Adjust		vt. 调整，使…适合；校准;vi. 调整，校准；适应
Administer		vt. 管理；执行；给予;vi. 给予帮助；执行遗产管理人的职责；担当管理人
administrator		n. 管理人；行政官
Admit		vt. 承认；准许进入；可容纳;vi. 承认；容许
Adopt		vt. 采取；接受；收养；正式通过;vi. 采取；过继
Adoption		n. 采用；收养；接受
Adult		n. 成年人;adj. 成年的；成熟的
Adulthood		n. 成年；成人期
Advance		n. 发展；前进；增长；预付款;adj. 预先的；先行的;vt. 提出；预付；使……前进；将……提前;vi. 前进；进展；上涨
Advanced		adj. 先进的；高级的；晚期的；年老的;v. 前进；增加；上涨（advance的过去式和过去分词形式）
advantage		n. 优势；利益；有利条件;vt. 有利于；使处于优势;vi. 获利
Advantageous		adj. 有利的；有益的
Adventure		n. 冒险；冒险精神；投机活动;vt. 冒险；大胆说出;vi. 冒险
Advertise		vt. 通知；为…做广告；使突出;vi. 做广告，登广告；作宣传
advertising		n. 广告；广告业；登广告;adj. 广告的；广告业的;v. 公告；为…做广告（advertise的ing形式）
Advice		n. 建议；忠告；劝告；通知
Advise		vt. 建议；劝告，忠告；通知；警告;vi. 建议；与…商量
affect		n. 情感；引起感情的因素;vt. 影响；感染；感动；假装;vi. 倾向；喜欢
afford		vt. 给予，提供；买得起;n. (Afford)人名；(英)阿福德
affordable		adj. 负担得起的
Against		prep. 反对，违反；靠；倚；防备;adj. 不利的；对立的
agency		n. 代理，中介；代理处，经销处
agent		n. 代理人，代理商；药剂；特工;adj. 代理的;vt. 由…作中介；由…代理;n. (Agent)人名；(罗)阿真特
Agreement		n. 协议；同意，一致
Agriculture		n. 农业；农艺，农学
aim		n. 目的；目标；对准;vt. 目的在于；引导；把…对准;vi. 打算；对准目标；瞄准
Allocate		vt. 分配；拨出；使坐落于;vi. 分配；指定
Allow		vt. 允许；给予；认可;vi. 容许；考虑
Alter		n. (Alter)人名；(英)奥尔特；(德、捷、葡、爱沙、立陶、拉脱、俄、西、罗、瑞典)阿尔特;vt. 改变，更改;vi. 改变；修改
Alternative		n. 二中择一；供替代的选择;adj. 供选择的；选择性的；交替的
Although		conj. 虽然，尽管
Altitude		n. 高地；高度；[数] 顶垂线；（等级和地位等的）高级
Amount		n. 数量；总额，总数;vi. 总计，合计；相当于；共计；产生…结果
Amuse		vt. 娱乐；消遣；使发笑；使愉快
Analyse		vt. 分析；分解；细察
Analysis		n. 分析；分解；验定
Ancestor		n. 始祖，祖先；被继承人
Ancestral		adj. 祖先的；祖传的
Ancient		n. 古代人；老人;adj. 古代的；古老的，过时的；年老的
Announce		vt. 宣布；述说；预示；播报;vi. 宣布参加竞选；当播音员
annual		n. 年刊，年鉴；一年生植物;adj. 年度的；每年的
Anxious		adj. 焦虑的；担忧的；渴望的；急切的
Apart		adj. 分离的；与众不同的;adv. 相距；与众不同地；分离着
Apparent		adj. 显然的；表面上的
Appear		vi. 出现；显得；似乎；出庭
Appearance		n. 外貌，外观；出现，露面
Application		n. 应用；申请；应用程序；敷用
Apply		vt. 申请；涂，敷；应用;vi. 申请；涂，敷；适用；请求
Appreciably		adv. 明显地；相当地；可察觉地
Appreciate		vt. 欣赏；感激；领会；鉴别;vi. 增值；涨价
approach		n. 方法；途径；接近;vt. 接近；着手处理;vi. 靠近
Appropriate		adj. 适当的;vt. 占用；拨出
Approve		vt. 批准；赞成；为…提供证据;vi. 批准；赞成；满意
Approximate		adj. [数] 近似的；大概的;vt. 近似；使…接近；粗略估计;vi. 接近于；近似于
approximately		adv. 大约，近似地；近于
Area		n. 区域，地区；面积；范围;n. (Area)人名；(西)阿雷亚
Arena		n. 舞台；竞技场;n. (Arena)人名；(英)阿里纳；(意、西、葡、德)阿雷纳
Argue		n. (Argue)人名；(英、法)阿格;vt. 辩论，争论；证明；说服;vi. 争论，辩论；提出理由
Argument		n. 论证；论据；争吵；内容提要
Arise		n. (Arise)人名；(西)阿里塞；(日)在濑(姓);vi. 出现；上升；起立
Arrangement		n. 布置；整理；准备
Arrive		n. (Arrive)人名；(法)阿里夫;vi. 到达；成功；达成；出生
artifact		n. 人工制品；手工艺品
Artificial		adj. 人造的；仿造的；虚伪的；非原产地的；武断的
as well as		也；和…一样；不但…而且
Ashamed		adj. 惭愧的，感到难为情的；耻于……的
Aspect		n. 方面；方向；形势；外貌
Assess		vt. 评定；估价；对…征税
Assessment		n. 评定；估价
Asset		n. 资产；优点；有用的东西；有利条件;n. (Asset)人名；(法)阿塞
Assign		vt. 分配；指派；[计][数] 赋值;vi. 将财产过户（尤指过户给债权人）
Assist		n. 帮助；助攻;vt. 帮助；促进;vi. 参加；出席
Assistance		n. 援助，帮助；辅助设备
Assistant		n. 助手，助理，助教;adj. 辅助的，助理的；有帮助的
Associate		n. 同事，伙伴；关联的事物;adj. 副的；联合的;vt. 联想；使联合；使发生联系;vi. 交往；结交
Association		n. 协会，联盟，社团；联合；联想
Assume		vt. 承担；假定；采取；呈现;vi. 装腔作势；多管闲事
Athlete		n. 运动员，体育家；身强力壮的人
Atmosphere		n. 气氛；大气；空气
Attach		vt. 使依附；贴上；系上；使依恋;vi. 附加；附属；伴随
Attack		n. 攻击；抨击；疾病发作;n. (Attack)人名；(瑞典)阿塔克;vt. 攻击；抨击；动手干;vi. 攻击；腐蚀
Attain		n. 成就;vt. 达到，实现；获得；到达;vi. 达到；获得；到达
Attempt		n. 企图，试图；攻击;vt. 企图，试图；尝试
Attend		vt. 出席；上（大学等）；照料；招待；陪伴;vi. 出席；致力于；照料；照顾
attendance		n. 出席；到场；出席人数
Attention		n. 注意力；关心；立正！（口令）
Attitude		n. 态度；看法；意见；姿势
Attract		vt. 吸引；引起;vi. 吸引；有吸引力
attraction		n. 吸引，吸引力；引力；吸引人的事物
attractive		adj. 吸引人的；有魅力的；引人注目的
Attribute		n. 属性；特质;vt. 归属；把…归于
audience		n. 观众；听众；读者；接见
Authority		n. 权威；权力；当局
Automatic		n. 自动机械；自动手枪;adj. 自动的；无意识的；必然的
autonomous		adj. 自治的；自主的；自发的
Available		adj. 有效的，可得的；可利用的；空闲的
average		n. 平均；平均数；海损;adj. 平均的；普通的;vt. 算出…的平均数；将…平均分配；使…平衡;vi. 平均为；呈中间色
avoid		vt. 避免；避开，躲避；消除
Aware		n. (Aware)人名；(阿拉伯、索)阿瓦雷;adj. 意识到的；知道的；有…方面知识的；懂世故的
Aware		n. (Aware)人名；(阿拉伯、索)阿瓦雷;adj. 意识到的；知道的；有…方面知识的；懂世故的
Awareness		n. 意识，认识；明白，知道
Back		n. 后面；背部；靠背；足球等的后卫；书报等的末尾;n. (Back)人名；(西、英、德、法、瑞典、捷)巴克;adj. 后面的；过去的；拖欠的;vt. 支持；后退；背书；下赌注;adv. 以前；向后地；来回地；上溯;vi. 后退；背靠；倒退
Background		n. 背景；隐蔽的位置;adj. 背景的；发布背景材料的;vt. 作…的背景
Backward		adj. 向后的；反向的；发展迟缓的;adv. 向后地；相反地
Bait		n. 饵；诱饵;n. (Bait)人名；(意)巴伊特;vt. 引诱；在…中放诱饵；折磨;vi. 中途休息
balance		n. 平衡；余额；匀称;vt. 使平衡；结算；使相称;vi. 保持平衡；相称；抵销;n. (Balance)人名；(西)巴兰塞
Ban		n. 禁令，禁忌;n. (Ban)人名；(日)蕃(名)；(缅、老、柬)班；(东南亚国家华语)万；(法)邦；(中)饼(广东话·威妥玛)；(德、塞、罗、阿拉伯)巴恩；(英)班恩;vt. 禁止，取缔
Barely		adv. 仅仅，勉强；几乎不；公开地；贫乏地
Base		n. 基础；底部；垒;n. (Base)人名；(日)马濑(姓);adj. 卑鄙的；低劣的;vt. 以…作基础
Basic		n. 基础；要素;adj. 基本的；基础的
Basis		n. 基础；底部；主要成分；基本原则或原理
Bear		n. 熊;n. (Bear)人名；(英)贝尔;vt. 忍受；具有；支撑;vi. 承受；结果实
Beat		n. 拍子；敲击；有规律的一连串敲打;n. (Beat)人名；(德)贝亚特;adj. 筋疲力尽的；疲惫不堪的;vt. 打；打败;vi. 打；打败；拍打；有节奏地舒张与收缩
Become		vt. 适合；相称;vi. 成为；变得；变成
begin		vi. 开始；首先;vt. 开始;;n. (Begin)人名；(以、德)贝京；(英)贝让
Behave		vt. 使守规矩；使表现得…;vi. 表现；（机器等）运转；举止端正；（事物）起某种作用
Behavior		n. 行为，举止；态度；反应
Belief		n. 相信，信赖；信仰；教义
Believe		vt. 相信；认为；信任;vi. 信任；料想；笃信宗教
Belong		vi. 属于，应归入；居住；适宜；应被放置
Below		n. (Below)人名；(英、德、芬、瑞典)贝洛;prep. 在…下面;adv. 在下面，在较低处；在本页下面
Bend		n. 弯曲;n. (Bend)人名；(瑞典)本德;vt. 使弯曲；使屈服；使致力；使朝向;vi. 弯曲，转弯；屈服；倾向；专心于
Beneficial		adj. 有益的，有利的；可享利益的
benefit		n. 利益，好处；救济金;vt. 有益于，对…有益;vi. 受益，得益
Bent		n. 爱好，嗜好;n. (Bent)人名；(英、西、丹、挪、印)本特;adj. 弯曲的；决心的
Besides		prep. 除…之外;adv. 此外；而且
Biological		adj. 生物的；生物学的
Biologist		n. 生物学家
blame		n. 责备；责任；过失;vt. 责备；归咎于
Blind		n. 掩饰，借口；百叶窗;n. (Blind)人名；(法)布兰；(德、瑞典)布林德;adj. 盲目的；瞎的;vt. 使失明；使失去理智;adv. 盲目地；看不见地
Block		n. 块；街区；大厦；障碍物;n. (Block)人名；(英、法、德、西、葡、芬、罗)布洛克;adj. 成批的，大块的；交通堵塞的;vt. 阻止；阻塞；限制
Boost		n. 推动；帮助；宣扬;n. (Boost)人名；(英)布斯特；(德)博斯特;vt. 促进；增加；支援;vi. 宣扬；偷窃
Bottom		n. 底部；末端；臀部；尽头;n. (Bottom)人名；(英)博顿;adj. 底部的;vt. 装底；测量深浅；查明真相;vi. 到达底部；建立基础
Brain		n. 头脑，智力；脑袋;n. (Brain)人名；(英)布雷恩;vt. 猛击…的头部
Brake		n. 闸，刹车；阻碍;n. (Brake)人名；(英)布雷克；(德)布拉克;vt. 刹车;vi. 刹车
Branch		n. 树枝，分枝；分部；支流;n. (Branch)人名；(英)布兰奇;vt. 分支；出现分歧;vi. 分支；出现分歧
Breakdown		n. 故障；崩溃；分解；分类；衰弱；跺脚曳步舞
breakthrough		n. 突破；突破性进展
Breed		n. [生物] 品种；种类，类型;n. (Breed)人名；(英)布里德;vt. 繁殖；饲养；养育，教育；引起;vi. 繁殖；饲养；产生
Budget		n. 预算，预算费;adj. 廉价的;vt. 安排，预定；把…编入预算;vi. 编预算，做预算
Bully		n. 欺凌弱小者；土霸;n. (Bully)人名；(法)布利;adj. 第一流的；特好的;vt. 欺负；威吓;adv. 很；十分;int. 好；妙;vi. 欺侮人
Bump		n. 肿块，隆起物；撞击;n. (Bump)人名；(英、西)邦普;vt. 碰，撞；颠簸;adv. 突然地，猛烈地;vi. 碰撞，撞击；颠簸而行
Burden		n. 负担；责任；船的载货量;n. (Burden)人名；(英)伯登;vt. 使负担；烦扰；装货于
Calculate		vt. 计算；预测；认为；打算;vi. 计算；以为；作打算
calculation		n. 计算；估计；计算的结果；深思熟虑
caloric		n. 热量;adj. 热量的；卡的
Canal		n. 运河；[地理] 水道；[建] 管道；灌溉水渠;n. (Canal)人名；(英、法、西、意、葡)卡纳尔；(土)贾纳尔;vt. 在…开凿运河
Cancel		n. 取消，撤销;n. (Cancel)人名；(法)康塞尔;vt. 取消；删去;vi. 取消；相互抵销
Cancer		[天] 巨蟹座
candidate		n. 候选人，候补者；应试者
capability		n. 才能，能力；性能，容量
Capable		adj. 能干的，能胜任的；有才华的
Capacity		n. 能力；容量；资格，地位；生产力
Capital		n. 首都，省会；资金；大写字母；资本家;n. (Capital)人名；(法)卡皮塔尔;adj. 首都的；重要的；大写的
capture		n. 捕获；战利品，俘虏;vt. 俘获；夺得
Care		n. 关怀；照料；谨慎；忧虑;n. (Care)人名；(英)凯尔；(塞)察蕾;vt. 在意；希望或喜欢;vi. 照顾；关心；喜爱；顾虑
Cartoon		n. 卡通片，[电影] 动画片；连环漫画;vt. 为…画漫画;vi. 画漫画
Case		n. 情况；实例；箱;n. (Case)人名；(英)凯斯；(西)卡塞；(法)卡斯;vt. 包围；把…装于容器中
Casual		n. 便装；临时工人；待命士兵;adj. 随便的；非正式的；临时的；偶然的
category		n. 种类，分类；[数] 范畴
Cause		n. 原因；事业；目标;vt. 引起；使遭受
Caution		n. 小心，谨慎；警告，警示;vt. 警告
celebration		n. 庆典，庆祝会；庆祝；颂扬
center		n. 中心，中央；中锋；中心点;adj. 中央的，位在正中的;vt. 集中，使聚集在一点；定中心;vi. 居中，被置于中心;n. (Center)人名；(英)森特
Central		n. 电话总机;adj. 中心的；主要的；中枢的
Century		n. 世纪，百年；（板球）一百分
Certain		n. (Certain)人名；(葡)塞尔塔因；(法)塞尔坦;adj. 某一；必然的；确信；无疑的；有把握的;pron. 某些；某几个
Chain		n. 链；束缚；枷锁;vt. 束缚；囚禁；用铁练锁住;n. (Chain)人名；(英)钱恩；(西)查因；(法)谢安
challenge		n. 挑战；怀疑;vt. 向…挑战
Change		n. 变化；找回的零钱;vt. 改变；交换;vi. 改变；兑换
Channel		n. 通道；频道；海峡;vt. 引导，开导；形成河道
Characteristic		n. 特征；特性；特色;adj. 典型的；特有的；表示特性的
Charge		n. 费用；电荷；掌管；控告；命令；负载;n. (Charge)人名；(法)沙尔热；(英)查奇;vt. 使充电；使承担；指责；装载；对…索费；向…冲去;vi. 充电；控告；索价；向前冲；记在账上
Check		n. 支票；阻止；阻止物;n. (Check)人名；(英)切克;vi. 核对无误；将军（象棋）；证明无误;vt. 检查；制止；寄存
Chemical		n. 化学制品，化学药品;adj. 化学的
Childhood		n. 童年时期；幼年时代
Choice		n. 选择；选择权；精选品;adj. 精选的；仔细推敲的
choose		vt. 选择，决定;vi. 选择，挑选
Chronic		n. (Chronic)人名；(英)克罗尼克;adj. 慢性的；长期的；习惯性的
Circle		n. 循环，周期；圆；圈子；圆形物;vt. 画圆圈；环绕…移动;vi. 盘旋，旋转；环行
Circulate		vt. 使循环；使流通；使传播;vi. 传播，流传；循环；流通
Circumstance		n. 环境，情况；事件；境遇
cite		vt. 引用；传讯；想起；表彰
Civilization		n. 文明；文化
Claim		n. 要求；声称；索赔；断言；值得;vt. 要求；声称；需要；认领;vi. 提出要求
Classic		n. 名著；经典著作；大艺术家;adj. 经典的；古典的，传统的；最优秀的
Classify		vt. 分类；分等
Clerk		n. 职员，办事员；店员；书记；记帐员;n. (Clerk)人名；(英)克拉克;vi. 当销售员，当店员
Clever		adj. 聪明的；机灵的；熟练的;n. (Clever)人名；(德)克勒韦尔；(英)克莱弗；(法)克勒韦
Click		n. 单击；滴答声;vt. 点击；使发咔哒声;vi. 作咔哒声
Climate		n. 气候；风气；思潮；风土
Climatic		adj. 气候的；气候上的；由气候引起的；受气候影响的
Clinic		n. 临床；诊所
Clue		n. 线索；（故事等的）情节;vt. 为…提供线索；为…提供情况
Coach		n. 教练；旅客车厢；长途公车；四轮大马车;vt. 训练；指导;vi. 作指导；接受辅导；坐马车旅行
Coastline		n. 海岸线
Cognitive		adj. 认知的，认识的
Coincidence		n. 巧合；一致；同时发生
Collapse		n. 倒塌；失败；衰竭;vt. 使倒塌，使崩溃；使萎陷;vi. 倒塌；瓦解；暴跌
Collate		vt. 核对，校对；校勘
Colleague		n. 同事，同僚
Collect		n. (Collect)人名；(英)科莱克特;adj. 由收件人付款的;vt. 收集；募捐;adv. 由收件人付款地;vi. 收集；聚集；募捐
Collection		n. 采集，聚集；[税收] 征收；收藏品；募捐
Colony		n. 殖民地；移民队
Colossal		adj. 巨大的；异常的，非常的
Combat		n. 战斗；争论;n. (Combat)人名；(法)孔巴;adj. 战斗的；为…斗争的;vt. 反对；与…战斗;vi. 战斗；搏斗
Combination		n. 结合；组合；联合；[化学] 化合
Combine		n. 联合收割机；联合企业;vt. 使化合；使联合，使结合;vi. 联合，结合；化合
Comfort		n. 安慰；舒适；安慰者;vt. 安慰；使（痛苦等）缓和
comfortable		n. 盖被;adj. 舒适的，舒服的
Comment		n. 评论；意见；批评;n. (Comment)人名；(德)科门特；(法)科芒;vt. 为…作评语;vi. 发表评论；发表意见
Commercial		n. 商业广告;adj. 商业的；营利的；靠广告收入的
commit		vt. 犯罪，做错事；把...交托给；指派…作战；使…承担义务
commitment		n. 承诺，保证；委托；承担义务；献身
common		n. 普通；平民；公有地;adj. 共同的；普通的；一般的；通常的;n. (Common)人名；(法)科蒙；(英)康芒
Commonly		adv. 一般地；通常地；普通地
communicate		vi. 通讯，传达；相通；交流；感染;vt. 传达；感染；显露
communication		n. 通讯，[通信] 通信；交流
Community		n. 社区；[生态] 群落；共同体；团体
comparable		adj. 可比较的；比得上的
compare		vi. 相比，匹敌；比较，区别；比拟（常与to连用）;vt. 比拟，喻为；[语]构成;n. 比较;n. (Compare)人名；(意)孔帕雷
Comparison		n. 比较；对照；比喻；比较关系
Compensation		n. 补偿；报酬；赔偿金
competition		n. 竞争；比赛，竞赛
competitive		adj. 竞争的；比赛的；求胜心切的
Complaint		n. 抱怨；诉苦；疾病；委屈
complement		n. 补语；余角；补足物;vt. 补足，补助
complementary		adj. 补足的，补充的
complete		adj. 完整的；完全的；彻底的;vt. 完成
Complex		n. 复合体；综合设施;adj. 复杂的；合成的
Complexity		n. 复杂，复杂性；复杂错综的事物
Complicated		adj. 难懂的，复杂的
Component		n. 成分；组件；[电子] 元件;adj. 组成的，构成的
compound		n. [化学] 化合物；混合物；复合词;adj. 复合的；混合的;vt. 合成；混合；和解妥协；搀合;vi. 和解；妥协
Comprehend		vt. 理解；包含；由…组成
Comprehensive		n. 综合学校；专业综合测验;adj. 综合的；广泛的；有理解力的
Compulsory		n. （花样滑冰、竞技体操等的）规定动作;adj. 义务的；必修的；被强制的
concentrate		n. 浓缩，精选；浓缩液;vi. 集中；浓缩；全神贯注；聚集;vt. 集中；浓缩
Concept		n. 观念，概念
concern		n. 关系；关心；关心的事;vt. 涉及，关系到；使担心
Conclude		vt. 推断；决定，作结论；结束;vi. 推断；断定；决定
conclusion		n. 结论；结局；推论
Concrete		n. 具体物；凝结物;adj. 混凝土的；实在的，具体的；有形的;vt. 使凝固；用混凝土修筑;vi. 凝结
Condition		n. 条件；情况；环境；身份;vt. 决定；使适应；使健康；以…为条件
Conduct		n. 进行；行为；实施;vt. 管理；引导；表现;vi. 导电；带领
Conference		n. 会议；协商；讨论；联盟
Confidence		n. 信心；信任；秘密;adj. （美）诈骗的；骗得信任的
Confident		adj. 自信的；确信的
Confine		n. 界限，边界;vt. 限制；禁闭
Confirm		vt. 确认；确定；证实；批准；使巩固
conflict		n. 冲突，矛盾；斗争；争执;vi. 冲突，抵触；争执；战斗
confront		vt. 面对；遭遇；比较
Confuse		vt. 使混乱；使困惑
confusion		n. 混淆，混乱；困惑
Congestion		n. 拥挤；拥塞；充血
Connect		vt. 连接；联合；关连;vi. 连接，连结；联合
connection		n. 连接；关系；连接件
consciousness		n. 意识；知觉；觉悟；感觉
Consensus		n. 一致；舆论；合意
consequence		n. 结果；重要性；推论
Conservation		n. 保存，保持；保护
Conservative		n. 保守派，守旧者;adj. 保守的
Conserve		n. 果酱；蜜饯;vt. 保存；将…做成蜜饯；使守恒
Consider		vt. 考虑；认为；考虑到；细想;vi. 考虑；认为；细想
Considerable		adj. 相当大的；重要的，值得考虑的
Consist		vi. 组成；在于；符合
consistent		adj. 始终如一的，一致的；坚持的
Constant		n. [数] 常数；恒量;n. (Constant)人名；(德)康斯坦特;adj. 不变的；恒定的；经常的
constitute		vt. 组成，构成；建立；任命
Construct		n. 构想，概念;vt. 建造，构造；创立
Construction		n. 建设；建筑物；解释；造句
Consultation		n. 咨询；磋商；[临床] 会诊；讨论会
Consume		vt. 消耗，消费；使…著迷；挥霍;vi. 耗尽，毁灭；耗尽生命
Consumer		n. 消费者；用户，顾客
Consumption		n. 消费；消耗；肺痨
Contact		n. 接触，联系;vt. 使接触;vi. 联系，接触
Contain		vt. 包含；控制；容纳；牵制（敌军）;vi. 含有；自制
contemporary		n. 同时代的人；同时期的东西;adj. 当代的；同时代的；属于同一时期的
Content		n. 内容，目录；满足；容量;n. (Content)人名；(法)孔唐;adj. 满意的;vt. 使满足
context		n. 环境；上下文；来龙去脉
Continent		n. 大陆，洲，陆地;adj. 自制的，克制的
Continue		vt. 继续说…；使…继续；使…延长;vi. 继续，延续；仍旧，连续
Continuous		adj. 连续的，持续的；继续的；连绵不断的
Contract		n. 合同；婚约;vt. 感染；订约；使缩短;vi. 收缩；感染；订约
contradict		vt. 反驳；否定；与…矛盾；与…抵触;vi. 反驳；否认；发生矛盾
Contrast		n. 对比；差别；对照物;vt. 使对比；使与…对照;vi. 对比；形成对照
contribute		vt. 贡献，出力；投稿；捐献;vi. 贡献，出力；投稿；捐献;[ 过去式 contributed 过去分词 contributed 现在分词 contributing ]
contribute to		有助于；捐献
Contribution		n. 贡献；捐献；投稿
Control		n. 控制；管理；抑制；操纵装置;vt. 控制；管理；抑制
Convenience		n. 便利；厕所；便利的事物
convention		n. 大会；[法] 惯例；[计] 约定；[法] 协定；习俗
Conventional		adj. 符合习俗的，传统的；常见的；惯例的
Conversation		n. 交谈；会话；社交
Converse		n. 逆行，逆向；倒；相反的事物;n. (Converse)人名；(英)康弗斯;n. 匡威（服装品牌）;adj. 相反的，逆向的；颠倒的;vi. 交谈，谈话；认识
Convert		n. 皈依者；改变宗教信仰者;n. (Convert)人名；(法)孔韦尔;vt. 使转变；转换…；使…改变信仰;vi. 转变，变换；皈依；改变信仰
Convey		vt. 传达；运输；让与
Convince		vt. 说服；使确信，使信服
Cooperative		n. 合作社;adj. 合作的；合作社的
Coordinate		n. 坐标；同等的人或物;adj. 并列的；同等的;vt. 调整；整合;vi. 协调
Cope		n. 长袍;n. (Cope)人名；(英)科普；(西)科佩;vi. 处理；对付；竞争
Copy		n. 副本；一册；摹仿;vt. 复制；复印；抄袭;vi. 复制；复印；抄袭
Core		n. 核心；要点；果心；[计] 磁心;n. (Core)人名；(英)科尔；(西、意)科雷;vt. 挖...的核
Corporation		n. 公司；法人（团体）；社团；大腹便便；市政当局
Correct		adj. 正确的；恰当的；端正的;vt. 改正；告诫;vi. 调整；纠正错误
Correction		n. 改正，修正
Correspond		vi. 符合，一致；相应；通信
Cost		n. 费用，代价，成本；损失;n. (Cost)人名；(英、罗)科斯特;vt. 花费；使付出；使花许多钱;vi. 花费
Count		n. 计数；计算；伯爵;n. (Count)人名；(法、德、南非)伯爵(欧洲贵族头衔)， 康特(人名);vt. 计算；认为;vi. 计数；有价值
Couple		n. 对；夫妇；数个;n. (Couple)人名；(法)库普勒;vt. 结合；连接；连合;vi. 结合；成婚
Courage		n. 勇气；胆量;n. (Courage)人名；(英)卡里奇；(法)库拉热
Course		n. 过程；进程；道路；一道菜;vt. 追赶；跑过;vi. 指引航线；快跑
Cover		n. 封面，封皮；盖子；掩蔽物;n. (Cover)人名；(英)科弗；(意)科韦尔;vt. 包括；采访，报导；涉及;vi. 覆盖；代替
Coverage		n. 覆盖，覆盖范围
Crash		n. 撞碎；坠毁；破产；轰隆声；睡觉;vt. 打碎；使坠毁、撞坏；擅自闯入;vi. 摔碎；坠落；发出隆隆声；(金融企业等)破产
Create		vt. 创造，创作；造成
Creative		adj. 创造性的
Creativity		n. 创造力；创造性
Creature		n. 动物，生物；人；创造物
Crime		n. 罪行，犯罪；罪恶；犯罪活动;vt. 控告……违反纪律
crisis		n. 危机；危险期；决定性时刻;adj. 危机的；用于处理危机的
Criteria		n. 标准，条件（criterion的复数）
Critic		n. 批评家，评论家；爱挑剔的人
Critical		adj. 鉴定的；[核] 临界的；批评的，爱挑剔的；危险的；决定性的；评论的
Criticize		vt. 批评；评论；非难;;vi. 批评；评论；苛求
Crucial		adj. 重要的；决定性的；定局的；决断的
Cultivate		vt. 培养；陶冶；耕作
Cultural		adj. 文化的；教养的
Culture		n. 文化，文明；修养；栽培;vt. [细胞][微] 培养（等于cultivate）
Cure		n. 治疗；治愈；[临床] 疗法;n. (Cure)人名；(罗)库雷；(法)屈尔；(英)丘尔；(塞)楚雷;vt. 治疗；治愈；使硫化；加工处理;vi. 治病；痊愈；受治疗；被硫化；被加工处理
Curious		adj. 好奇的，有求知欲的；古怪的；爱挑剔的
Current		n. （水，气，电）流；趋势；涌流;n. (Current)人名；(英)柯伦特;adj. 现在的；流通的，通用的；最近的；草写的
Curriculum		n. 课程;总课程
Curve		n. 曲线；弯曲；曲线球；曲线图表;adj. 弯曲的；曲线形的;vt. 弯；使弯曲;vi. 成曲形
Cushion		n. 垫子；起缓解作用之物；（猪等的）臀肉；银行储蓄;vt. 给…安上垫子；把…安置在垫子上；缓和…的冲击
Custom		n. 习惯；风俗；海关;adj. 定制的，定做的
Cycle		n. 循环；周期；自行车；整套；一段时间;vt. 使循环；使轮转;vi. 循环；骑自行车；轮转
Damage		n. 损害；损毁;vt. 损害，毁坏;vi. 损害；损毁；赔偿金
Damp		n. 潮湿，湿气;adj. 潮湿的;vt. 使潮湿；使阻尼；使沮丧，抑制;vi. 减幅，阻尼；变潮湿
Data		n. 数据（datum的复数）；资料;n. (Data)人名；(日)驮太 (姓)；(印、葡)达塔
Dawn		n. 黎明；开端;n. (Dawn)人名；(西)道恩;vt. 破晓；出现；被领悟
Deadline		n. 截止期限，最后期限
Deal		n. 交易；（美）政策；待遇；份量;n. (Deal)人名；(英、西)迪尔;vt. 处理；给予；分配；发牌;vi. 处理；讨论；对待；做生意
Deal with		处理；涉及；做生意
Debate		n. 辩论；辩论会;vt. 辩论，争论，讨论;vi. 辩论，争论，讨论
Decade		n. 十年，十年期；十
decide		vi. 决定，下决心;vt. 决定；解决；判决
Decision		n. 决定，决心；决议
declaration		n. （纳税品等的）申报；宣布；公告；申诉书
Declare		vt. 宣布，声明；断言，宣称;vi. 声明，宣布
decline		n. 下降；衰退；斜面;vt. 谢绝；婉拒;vi. 下降；衰落；谢绝
Decrease		n. 减少，减小；减少量;vt. 减少，减小;vi. 减少，减小
Dedicate		vt. 致力；献身；题献
Deduce		vt. 推论，推断；演绎出
Deem		n. (Deem)人名；(英)迪姆;vt. 认为，视作；相信;vi. 认为，持某种看法；作某种评价
Defensive		n. 防御；守势;adj. 自卫的；防御用的
deficiency		n. 缺陷，缺点；缺乏；不足的数额
define		vt. 定义；使明确；规定;n. (Define)人名；(英)德法恩；(葡)德菲内
definition		n. 定义；[物] 清晰度；解说
Degrade		vt. 贬低；使……丢脸；使……降级；使……降解;vi. 降级，降低；退化
degree		n. 程度，等级；度；学位；阶层
delay		n. 延期；耽搁；被耽搁或推迟的时间;vt. 延期；耽搁;vi. 延期；耽搁;n. (Delay)人名；(英)迪莱；(法)德莱
Deliver		n. 投球;vt. 交付；发表；递送；释放；给予（打击）；给…接生;vi. 实现；传送；履行；投递
delivery		n. [贸易] 交付；分娩；递送
Demand		n. [经] 需求；要求；需要;n. (Demand)人名；(德)德曼德;vt. 要求；需要；查询;vi. 需要；请求；查问
Demanding		adj. 苛求的；要求高的；吃力的;v. 要求；查问（demand的ing形式）
Demonstrate		vt. 证明；展示；论证;vi. 示威
Density		n. 密度
Deny		vt. 否定，否认；拒绝给予；拒绝…的要求;vi. 否认；拒绝
department		n. 部；部门；系；科；局
Depend		vi. 依赖，依靠；取决于；相信，信赖
Dependent		n. 依赖他人者；受赡养者;adj. 依靠的；从属的；取决于…的
Deposit		n. 存款；保证金；沉淀物;vt. 使沉积；存放;vi. 沉淀
Depress		vt. 压抑；使沮丧；使萧条
Deprive		vt. 使丧失，剥夺
Depth		n. [海洋] 深度；深奥
Derive from		源出，来自，得自；衍生于
descendent		n. 后裔；派生物;adj. 派生的；降落的；世袭的
describe		vt. 描述，形容；描绘
description		n. 描述，描写；类型；说明书
Deserve		vt. 应受，应得;vi. 应受，应得
Design		n. 设计；图案;vt. 设计；计划；构思;vi. 设计
Desire		n. 欲望；要求，心愿；性欲;n. (Desire)人名；(刚(布)、英)德西雷;vt. 想要；要求；希望得到…;vi. 渴望
Desire		n. 欲望；要求，心愿；性欲;n. (Desire)人名；(刚(布)、英)德西雷;vt. 想要；要求；希望得到…;vi. 渴望
despite		prep. 尽管，不管;n. 轻视；憎恨；侮辱
Destination		n. 目的地，终点
Destroy		vt. 破坏；消灭；毁坏
Destruction		n. 破坏，毁灭；摧毁
Detail		n. 细节，详情;vt. 详述；选派;vi. 画详图
Detailed		adj. 详细的，精细的；复杂的，详尽的;v. 详细说明（detail的过去分词）
Detect		vt. 察觉；发现；探测
Determine		vt. 决定；判决；使…下定决心;vi. 确定；决定；判决，终止
Devastate		vt. 毁灭；毁坏
develop		vi. 发育；生长；进化；显露;vt. 开发；进步；使成长；使显影
Development		n. 发展；开发；发育；住宅小区（专指由同一开发商开发的）；[摄] 显影
Device		n. 装置；策略；图案
Devise		n. 遗赠;n. (Devise)人名；(法)德维兹；(英)德维斯;vt. 设计；想出；发明；图谋；遗赠给
Devote		vt. 致力于；奉献
diet		n. 饮食；食物；规定饮食;vt. [医] 照规定饮食;vi. 节食;n. (Diet)人名；(法)迪耶
Differ		n. (Differ)人名；(法)迪费;vt. 使…相异；使…不同;vi. 相异；意见分歧
difficult		adj. 困难的；不随和的；执拗的
Digest		n. 文摘；摘要;vt. 消化；吸收；融会贯通;vi. 消化
Digitize		vt. [计] 数字化
dimension		n. 方面;[数] 维；尺寸；次元；容积 vt. 标出尺寸;adj. 规格的
Diminish		vt. 使减少；使变小;vi. 减少，缩小；变小
Direct		adj. 直接的；直系的；亲身的；恰好的;vt. 管理；指挥；导演；指向;adv. 直接地；正好；按直系关系;vi. 指导；指挥
Direction		n. 方向；指导；趋势；用法说明
Directly		conj. 一…就;adv. 直接地；立即；马上；正好地；坦率地
Disable		vt. 使失去能力；使残废；使无资格
disadvantage		n. 缺点；不利条件；损失
Disagree		vi. 不同意；不一致；争执；不适宜
Disappear		vt. 使…不存在；使…消失;vi. 消失；失踪；不复存在
Disappoint		vt. 使失望
Disaster		n. 灾难，灾祸；不幸
Discharge		n. 排放；卸货；解雇;vt. 解雇；卸下；放出；免除;vi. 排放；卸货；流出
discipline		n. 学科；纪律；训练；惩罚;vt. 训练，训导；惩戒
Discourage		vt. 阻止；使气馁
Discover		vt. 发现；发觉;vi. 发现
discovery		n. 发现，发觉；被发现的事物
Discuss		vt. 讨论；论述，辩论
Discussion		n. 讨论，议论
disease		n. 病，[医] 疾病；弊病;vt. 传染；使…有病
Disillusion		n. 幻灭；醒悟;vt. 使醒悟；使不再抱幻想
disorder		n. 混乱；骚乱;vt. 使失调；扰乱
Dispense		vt. 分配，分发；免除；执行;vi. 免除，豁免
Displace		vt. 取代；置换；转移；把…免职；排水
Display		n. 显示；炫耀;adj. 展览的；陈列用的;vt. 显示；表现；陈列;vi. [动] 作炫耀行为
Distance		n. 距离；远方；疏远；间隔;vt. 疏远；把…远远甩在后面
Distant		adj. 遥远的；冷漠的；远隔的
Distinguish		vt. 区分；辨别；使杰出，使表现突出;vi. 区别，区分；辨别
Distribute		vt. 分配；散布；分开；把…分类
Distribution		n. 分布；分配
District		n. 区域；地方；行政区
Disturb		vt. 打扰；妨碍；使不安；弄乱；使恼怒;vi. 打扰；妨碍
Diverse		adj. 不同的；多种多样的；变化多的
Diversity		n. 多样性；差异
Divide		n. [地理] 分水岭，分水线;vt. 划分；除；分开；使产生分歧;vi. 分开；意见分歧
Domain		n. 领域；域名；产业；地产;n. (Domain)人名；(英、法)多曼
Domestic		n. 国货；佣人;adj. 国内的；家庭的；驯养的；一心只管家务的
Dominant		n. 显性;adj. 显性的；占优势的；支配的，统治的
Dominate		vt. 控制；支配；占优势；在…中占主要地位;vi. 占优势；处于支配地位
Double		n. 两倍；双精度型;n. (Double)人名；(法)杜布勒；(英)道布尔;adj. 双重的；两倍的;vt. 使加倍;adv. 双重地；两倍地；弓身地;vi. 加倍，加倍努力；快步走
Doubt		n. 怀疑；疑问；疑惑;v. 怀疑；不信；恐怕；拿不准
Dramatic		adj. 戏剧的；引人注目的；激动人心的
dramatical		adj. 剧烈的，戏剧的
dramatically		adv. 戏剧地；引人注目地
Draw		n. 平局；抽签;n. (Draw)人名；(英)德劳;vt. 画；拉；吸引;vi. 拉；拖
Drawback		n. 缺点，不利条件；退税
Drive		n. 驱动器；驾车；[心理] 内驱力，推进力；快车道;vt. 推动，发动（机器等）；驾驶（马车，汽车等）；驱赶;vi. 开车；猛击；飞跑
Drop		n. 滴；落下；空投；微量；滴剂;vt. 滴；使降低；使终止；随口漏出;vi. 下降；终止
due to		adv. 由于；应归于
Duplicate		n. 副本；复制品;adj. 复制的；二重的;vt. 复制；使加倍;vi. 复制；重复
Durable		n. 耐用品;adj. 耐用的，持久的
Duration		n. 持续
dwelling		n. 住处；寓所;v. 居住（dwell的现在分词）
Dynamic		n. 动态；动力;adj. 动态的；动力的；动力学的；有活力的
echo		n. 回音；效仿;vt. 反射；重复;vi. 随声附和；发出回声
Ecologist		n. 生态学者
Ecology		n. 生态学；社会生态学
Economic		adj. 经济的，经济上的；经济学的
Economy		n. 经济；节约；理财;n. (Economy)人名；(英)伊科诺米
Ecosystem		n. 生态系统
Edge		n. 边缘；优势；刀刃；锋利;n. (Edge)人名；(英)埃奇;vt. 使锐利；将…开刃；给…加上边;vi. 缓缓移动；侧着移动
Education		n. 教育；培养；教育学
Effect		n. 影响；效果；作用;vt. 产生；达到目的
Effective		adj. 有效的，起作用的；实际的，实在的；给人深刻印象
Efficient		adj. 有效率的；有能力的；生效的
Efficiently		adv. 有效地；效率高地（efficient的副词形式）
effort		n. 努力；成就
Elaborate		adj. 精心制作的；详尽的；煞费苦心的;vt. 精心制作；详细阐述；从简单成分合成（复杂有机物）;vi. 详细描述；变复杂
Electricity		n. 电力；电流；强烈的紧张情绪
Electronic		adj. 电子的;电子地
Element		n. 元素；要素；原理；成分；自然环境;n. (Element)人名；(德)埃勒门特；(英)埃利门特
Elementary		adj. 基本的；初级的；[化学] 元素的
Elevate		vt. 提升；举起；振奋情绪等；提升…的职位
eliminate		vt. 消除；排除
Elusive		adj. 难懂的；易忘的；逃避的；难捉摸的
Embarrassment		n. 窘迫，难堪；使人为难的人或事物；拮据
Embrace		n. 拥抱;vt. 拥抱；信奉，皈依；包含;vi. 拥抱
emerge		vi. 浮现；摆脱；暴露
Emission		n. （光、热等的）发射，散发；喷射；发行;n. (Emission)人名；(英)埃米申
Emit		vt. 发出，放射；发行；发表
Emotion		n. 情感；情绪
Emotional		adj. 情绪的；易激动的；感动人的
Emphasis		n. 重点；强调；加强语气
Emphasize		vt. 强调，着重
Employ		n. 使用；雇用;vt. 使用，采用；雇用；使忙于，使从事于
Employment		n. 使用；职业；雇用
enable		vt. 使能够，使成为可能；授予权利或方法
Encounter		n. 遭遇，偶然碰见;vt. 遭遇，邂逅；遇到;vi. 遭遇；偶然相遇
Encourage		vt. 鼓励，怂恿；激励；支持
end up		结束；死亡
Endanger		vt. 危及；使遭到危险
Endurance		n. 忍耐力；忍耐；持久；耐久
Energy		n. [物] 能量；精力；活力；精神
Engage		vt. 吸引，占用；使参加；雇佣；使订婚；预定;vi. 从事；答应，保证；交战；啮合
engage in		从事于（参加）
Engineer		n. 工程师；工兵；火车司机;vt. 设计；策划；精明地处理;vi. 设计；建造
Engross		vt. 使全神贯注；用大字体书写；正式写成（决议等）；独占；吸引
Enhance		vt. 提高；加强；增加
Enjoy		vt. 欣赏，享受；喜爱；使过得快活
Enormous		adj. 庞大的，巨大的；凶暴的，极恶的
Enquiry		n. [计] 询问，[贸易] 询盘
Ensure		vt. 保证，确保；使安全
entire		adj. 全部的，整个的；全体的;n. (Entire)人名；(英)恩泰尔
environment		n. 环境，外界
environmental		adj. 环境的，周围的；有关环境的
Equal		n. 对手；匹敌；同辈；相等的事物;adj. 平等的；相等的；胜任的;vt. 等于；比得上
Equally		adv. 同样地；相等地，平等地；公平地
Equator		n. 赤道
Equip		vt. 装备，配备
equipment		n. 设备，装备；器材
equivalent		n. 等价物，相等物;adj. 等价的，相等的；同意义的
Error		n. 误差；错误；过失
Escape		n. 逃跑；逃亡;vt. 逃避，避免；被忘掉;vi. 逃脱；避开；溜走
Essence		n. 本质，实质；精华；香精;n. (Essence)人名；(英)埃森丝
Essential		n. 本质；要素；要点；必需品;adj. 基本的；必要的；本质的；精华的
Essentially		adv. 本质上；本来
establish		vi. 植物定植;vt. 建立；创办；安置
establishment		n. 确立，制定；公司；设施
Estimate		n. 估计，估价；判断，看法;vt. 估计，估量；判断，评价;vi. 估计，估价
Ethical		n. 处方药;adj. 伦理的；道德的；凭处方出售的
Evaluate		vt. 评价；估价；求…的值;vi. 评价；估价
Even		n. (Even)人名；(法)埃旺；(德)埃文；(英)埃文;adj. [数] 偶数的；平坦的；相等的;vt. 使平坦；使相等;adv. 甚至；即使；还；实际上;vi. 变平；变得可比较；成为相等
Evenly		adv. 均匀地；平衡地；平坦地；平等地
Event		n. 事件，大事；项目；结果
Eventually		adv. 最后，终于
evidence		n. 证据，证明；迹象；明显;vt. 证明
Evidently		adv. 显然，明显地；清楚地
Evitable		adj. 可以避免的
Evolution		n. 演变；进化论；进展
evolutionary		adj. 进化的；发展的；渐进的
Evolve		vt. 发展，进化；进化；使逐步形成；推断出;vi. 发展，进展；进化；逐步形成
Exact		adj. 准确的，精密的；精确的;vt. 要求；强求；急需;vi. 勒索钱财
Exactly		adv. 恰好地；正是；精确地；正确地
Exaggerate		vt. 使扩大；使增大;vi. 夸大；夸张
examination		n. 考试；检查；查问
Examine		vt. 检查；调查； 检测；考试;vi. 检查；调查
Excavation		n. 挖掘，发掘
Exceed		vt. 超过；胜过;vi. 超过其他
Except		conj. 除了；要不是;prep. 除…之外;vt. 不计；把…除外;vi. 反对
Exception		n. 例外；异议
Exceptional		n. 超常的学生;adj. 异常的，例外的
Excess		n. 超过，超额；过度，过量；无节制;adj. 额外的，过量的；附加的
exchange		n. 交换；交流；交易所；兑换;vt. 交换；交易；兑换;vi. 交换；交易；兑换
Excite		vt. 激起；刺激…，使…兴奋;vi. 激动
Excitement		n. 兴奋；刺激；令人兴奋的事物
exclude		vt. 排除；排斥；拒绝接纳；逐出
Exclusive		n. 独家新闻；独家经营的项目；排外者;adj. 独有的；排外的；专一的
Exemplify		vt. 例证；例示
Exhausted		adj. 疲惫的；耗尽的;v. 耗尽；用尽；使…精疲力尽（exhaust的过去式）
Exist		vi. 存在；生存；生活；继续存在
Existence		n. 存在，实在；生存，生活；存在物，实在物
expand		vt. 扩张；使膨胀；详述;vi. 发展；张开，展开
Expansion		n. 膨胀；阐述；扩张物
Expect		vt. 期望；指望；认为；预料;vi. 期待；预期
Expectation		n. 期待；预期；指望
Expenditure		n. 支出，花费；经费，消费额
Expense		n. 损失，代价；消费；开支;vt. 向…收取费用;vi. 被花掉
experience		n. 经验；经历；体验;vt. 经验；经历；体验
Experiment		n. 实验，试验；尝试;vi. 尝试；进行实验
Experimental		adj. 实验的；根据实验的；试验性的
expert		n. 专家；行家；能手;adj. 熟练的；内行的；老练的;vt. 当专家；在…中当行家;n. (Expert)人名；(法)埃克斯佩
Explain		v. 说明；解释
explanation		n. 说明，解释；辩解
Explore		vt. 探索；探测；探险;vi. 探索；探测；探险
Explosion		n. 爆炸；爆发；激增
Export		n. 输出，出口；出口商品;vt. 输出，出口;vi. 输出物资
Expose		vt. 揭露，揭发；使曝光；显示
Express		n. 快车，快递，专使；捷运公司;adj. 明确的；迅速的；专门的;vt. 表达；快递
Expression		n. 表现，表示，表达；表情，脸色，态度，腔调，声调；式，符号；词句，语句，措辞，说法
Extend		vt. 延伸；扩大；推广；伸出；给予；使竭尽全力；对…估价;vi. 延伸；扩大；伸展；使疏开
Extension		n. 延长；延期；扩大；伸展；电话分机
Extensive		adj. 广泛的；大量的；广阔的
Extensively		adv. 广阔地；广大地
Extent		n. 程度；范围；长度
external		n. 外部；外观；外面;adj. 外部的；表面的；[药] 外用的；外国的；外面的
Extinct		adj. 灭绝的，绝种的；熄灭的;vt. 使熄灭
Extinction		n. 消失；消灭；废止
Extra		n. 临时演员；号外；额外的事物；上等产品;adj. 额外的，另外收费的；特大的;adv. 特别地，非常；另外
Extract		n. 汁；摘录；榨出物；选粹;vt. 提取；取出；摘录；榨取
Extraordinary		adj. 非凡的；特别的；离奇的；临时的；特派的
Extreme		n. 极端；末端；最大程度；极端的事物;adj. 极端的；极度的；偏激的；尽头的
Extremely		adv. 非常，极其；极端地
Facial		n. 美容，美颜；脸部按摩;adj. 面部的，表面的；脸的，面部用的
Facility		n. 设施；设备；容易；灵巧
fact		n. 事实；实际；真相
Factor		n. 因素；要素；[物] 因数；代理人;n. (Factor)人名；(英)法克特;vt. 把…作为因素计入；代理经营；把…分解成;vi. 做代理商
fade		n. [电影][电视] 淡出；[电影][电视] 淡入;adj. 平淡的；乏味的;vi. 褪色；凋谢；逐渐消失;vt. 使褪色;n. (Fade)人名；(法)法德
Fail		n. 不及格;n. (Fail)人名；(葡、捷)法伊尔；(法)法伊;vt. 不及格；使失望；忘记；舍弃;vi. 失败，不及格；破产；缺乏；衰退
failure		n. 失败；故障；失败者；破产
Faith		n. 信仰；信念；信任；忠实;n. (Faith)人名；(匈)福伊特；(英)费思，费丝(女名)；(瑞典)法伊特
Fall		n. 下降；秋天；瀑布;n. (Fall)人名；(法、芬、瑞典)法尔；(英、匈)福尔；(阿拉伯)法勒;adj. 秋天的;vt. 砍倒；击倒;vi. 落下；变成；来临；减弱
familiar		n. 常客；密友;adj. 熟悉的；常见的；亲近的;n. (Familiar)人名；(西)法米利亚尔
Famous		adj. 著名的；极好的，非常令人满意的
Fascinate		vt. 使着迷，使神魂颠倒;vi. 入迷
Fasten		n. (Fasten)人名；(英)法森;vt. 使固定；集中于；扎牢；强加于;vi. 扣紧；抓住；集中注意力
Fault		n. 故障；[地质] 断层；错误；缺点；毛病；（网球等）发球失误;vt. （通常用于疑问句或否定句）挑剔;vi. 弄错；产生断层
Favor		n. 喜爱；欢心；好感;vt. 赞成；喜欢；像；赐予；证实
Fear		n. 害怕；恐惧；敬畏；担心;vt. 害怕；敬畏；为…担心;vi. 害怕；敬畏；为…担心
Feature		n. 特色，特征；容貌；特写或专题节目;vt. 特写；以…为特色；由…主演;vi. 起重要作用
Federation		n. 联合；联邦；联盟；联邦政府
Feed		n. 饲料；饲养；（动物或婴儿的）一餐;vt. 喂养；供给；放牧；抚养（家庭等）；靠…为生;vi. 吃东西；流入
feedback		n. 反馈；成果，资料；回复
Female		n. 女人；[动] 雌性动物;adj. 女性的；雌性的；柔弱的，柔和的
Fertilize		vt. 使受精；使肥沃
Fertilizer		n. [肥料] 肥料；受精媒介物；促进发展者
Field		n. 领域；牧场；旷野；战场；运动场;n. (Field)人名；(英、法、德、葡)菲尔德;adj. 扫描场；田赛的；野生的;vt. 把暴晒于场上；使上场;vi. 担任场外队员
Fierce		n. (Fierce)人名；(英)菲尔斯;adj. 凶猛的；猛烈的；暴躁的
fight		n. 打架；战斗，斗志;vi. 打架；与…打仗，与…斗争；反对…提案
Figure		n. 数字；人物；图形；价格；（人的）体形；画像;vt. 计算；认为；描绘；象征;vi. 计算；出现；扮演角色
Fill		n. 满足；填满的量；装填物;n. (Fill)人名；(德、俄、匈)菲尔;vt. 装满，使充满；满足；堵塞；任职;vi. 被充满，膨胀
Final		n. 决赛；期末考试；当日报纸的末版;adj. 最终的；决定性的；不可更改的
Finally		adv. 最后；终于；决定性地
Finance		n. 财政，财政学；金融;n. (Finance)人名；(法)菲南斯;vt. 负担经费，供给…经费;vi. 筹措资金
financial		adj. 金融的；财政的，财务的
finitude		n. 有限；界限；限制
Firm		n. 公司；商号;adj. 坚定的；牢固的；严格的；结实的;vt. 使坚定；使牢固;adv. 稳固地;vi. 变坚实；变稳固
fitness		n. 健康；适当；适合性
Fix		n. 困境；方位；贿赂;n. (Fix)人名；(英、法、德、瑞典)菲克斯;vt. 使固定；修理；安装；准备;vi. 固定；注视
flat		n. 平地；公寓；平面;adj. 平的；单调的；不景气的；干脆的；平坦的；扁平的；浅的;vi. 逐渐变平；[音乐]以降调唱（或奏）;vt. 使变平；[音乐]使（音调）下降，尤指降半音;adv. （尤指贴着另一表面）平直地；断然地；水平地；直接地，完全地;n. （法）弗拉特（人名）；（英）弗莱特（人名）
Flexibility		n. 灵活性；弹性；适应性
Flexible		adj. 灵活的；柔韧的；易弯曲的
Flight		n. 飞行；班机；逃走;n. (Flight)人名；(英)弗莱特;vt. 射击；使惊飞;vi. 迁徙
Flourish		n. 兴旺；茂盛；挥舞；炫耀；华饰;vt. 夸耀；挥舞;vi. 繁荣，兴旺；茂盛；活跃；处于旺盛时期
Fluctuate		vt. 使波动；使动摇;vi. 波动；涨落；动摇
Fluent		adj. 流畅的，流利的；液态的；畅流的
focus		n. 焦点；中心；清晰；焦距;vt. 使集中；使聚焦;vi. 集中；聚焦；调节焦距;n. (Focus)人名；(瑞典)福库斯
follow		n. 跟随；追随;vi. 跟随；接着;vt. 跟随；遵循；追求；密切注意，注视；注意；倾听
Following		n. 下列事物；一批追随者;adj. 下面的；其次的，接着的;v. 跟随；沿行（follow的ing形式）
for instance		例如
for the sake of		为了；为了…的利益
Force		n. 力量；武力；军队；魄力;n. (Force)人名；(意)福尔切；(英、法)福斯;vt. 促使，推动；强迫；强加
Foreign		adj. 外国的；外交的；异质的；不相关的
Form		n. 形式，形状；形态，外形；方式；表格;n. (Form)人名；(英)福姆；(法、德)福尔姆;vt. 构成，组成；排列，组织；产生，塑造;vi. 形成，构成；排列
Formal		n. 正式的社交活动；夜礼服;n. (Formal)人名；(法)福马尔;adj. 正式的；拘谨的；有条理的
Format		n. 格式；版式；开本;vt. 使格式化；规定…的格式;vi. 设计版式
Former		n. 模型，样板；起形成作用的人;n. (Former)人名；(法)福尔梅；(德、捷)福尔默;adj. 从前的，前者的；前任的
formulate		vt. 规划；用公式表示；明确地表达
Fortunately		adv. 幸运地
Fortune		n. 财富；命运；运气;n. (Fortune)人名；(英)福琼；(法)福蒂纳;vt. 给予财富;vi. 偶然发生
Foster		n. (Foster)人名；(英、捷、意、葡、法、德、俄、西)福斯特;adj. 收养的，养育的;vt. 培养；养育，抚育；抱（希望等）
Found		v. 找到（find的过去分词）;vt. 创立，建立；创办
Fragment		n. 碎片；片断或不完整部分;vt. 使成碎片;vi. 破碎或裂开
Framework		n. 框架，骨架；结构，构架
freedom		n. 自由，自主；直率;n. (Freedom)人名；(英)弗里德姆
Freeze		n. 冻结；凝固;n. (Freeze)人名；(英)弗里兹;vt. 使…冻住；使…结冰;vi. 冻结；冷冻；僵硬
Frequency		n. 频率；频繁
Frequent		adj. 频繁的；时常发生的；惯常的;vt. 常到，常去；时常出入于
frustrating		v. 使沮丧（frustrate的ing形式）;adj. 令人沮丧的
Fuel		n. 燃料；刺激因素;vt. 供以燃料，加燃料;vi. 得到燃料
Fulfill		vt. 履行；实现；满足；使结束（等于fulfil）
Function		n. 功能；[数] 函数；职责；盛大的集会;vi. 运行；活动；行使职责
fund		n. 基金；资金；存款;vt. 投资；资助;n. (Fund)人名；(德)丰德
fundamental		n. 基本原理；基本原则;adj. 基本的，根本的
Further		adj. 更远的；深一层的;vt. 促进，助长；增进;adv. 进一步地；而且；更远地
furthermore		adv. 此外；而且
Future		n. 未来；前途；期货；将来时;adj. 将来的，未来的
Gain		n. 增加；利润；收获;n. (Gain)人名；(英、匈、法)盖恩;vt. 获得；增加；赚到;vi. 增加；获利
Gather		n. 聚集；衣褶；收获量;n. (Gather)人名；(德)加特;vt. 收集；收割；使…聚集；使…皱起;vi. 聚集；化脓；皱起
Gene		n. 吉恩（男子名）
General		n. 一般；将军，上将；常规;n. (General)人名；(英)杰纳勒尔;adj. 一般的，普通的；综合的；大体的
Generally		adv. 通常；普遍地，一般地
Generate		vt. 使形成；发生；生殖
generation		n. 一代；产生；一代人；生殖
genetic		adj. 遗传的；基因的；起源的
Genius		n. 天才，天赋；精神
geographic		adj. 地理的；地理学的
Geography		n. 地理；地形
Gesture		n. 姿态；手势;vt. 用动作表示;vi. 作手势；用动作示意
Giant		n. 巨人；伟人；[动] 巨大的动物;adj. 巨大的；巨人般的
Given that		只要是，考虑到；假定，已知
Global		adj. 全球的；总体的；球形的
globalisation		n. 全球化
Globe		n. 地球；地球仪；球体;vt. 使…成球形;vi. 成球状
Goal		n. 目标；球门，得分数；终点;vi. 攻门，射门得分
Good-quality		优质
Government		n. 政府；政体；管辖
Grade		n. 年级；等级；成绩；级别；阶段;n. (Grade)人名；(英)格雷德；(法、德、西、葡、塞、瑞典)格拉德;vt. 评分；把…分等级;vi. 分等级；逐渐变化
Gradual		n. 弥撒升阶圣歌集;adj. 逐渐的；平缓的
Gradually		adv. 逐步地；渐渐地
Grant		n. 拨款；[法] 授予物;n. (Grant)人名；(瑞典、葡、西、俄、罗、英、塞、德、意)格兰特；(法)格朗;vt. 授予；允许；承认;vi. 同意
Graphic		adj. 形象的；图表的；绘画似的
Grasp		n. 抓住；理解；控制;vt. 抓住；领会;vi. 抓
Growing		adj. 发展的；成长的;v. 生长（grow的ing形式）
growth		n. 增长；发展；生长；种植
Guarantee		n. 保证；担保；保证人；保证书；抵押品;vt. 保证；担保
Guess		n. 猜测；推测;n. (Guess)人名；(英)格斯；(德)居斯;n. 盖尔斯（美国服装品牌）;vt. 猜测；认为；推测；猜中;vi. 猜；推测；猜中
Guidance		n. 指导，引导；领导
Guide		n. 指南；向导；入门书;n. (Guide)人名；(法、葡)吉德;vt. 引导；带领；操纵;vi. 担任向导
Habit		n. 习惯，习性；嗜好;vt. 使穿衣
Habitat		n. [生态] 栖息地，产地;n. (Habitat)人名；(德)哈比塔特
Hand		n. 手，手艺；帮助；指针；插手;n. (Hand)人名；(英、瑞典)汉德;vt. 传递，交给；支持；搀扶
Handle		n. [建] 把手；柄；手感；口实;vt. 处理；操作；运用；买卖；触摸;vi. 搬运；易于操纵
Happen		vi. 发生；碰巧；偶然遇到
Harbour		n. 海港（等于harbor）；避难所;n. (Harbour)人名；(英)哈伯;vt. 庇护；藏匿；入港停泊;vi. 藏匿；入港停泊；庇护
Harm		n. 伤害；损害;n. (Harm)人名；(德)哈尔姆;vt. 伤害；危害；损害
harsh		adj. 严厉的；严酷的；刺耳的；粗糙的；刺目的;n. (Harsh)人名；(英)哈什
Healthy		adj. 健康的，健全的；有益于健康的;
Height		n. 高地；高度；身高；顶点
Herbal		n. 植物志；草本书;adj. 草药的；草本的
heritage		n. 遗产；传统；继承物；继承权;n. (Heritage)人名；(英)赫里蒂奇
Hesitation		n. 犹豫
Hidden		n. (Hidden)人名；(英)希登;adj. 隐藏的;v. 隐藏，躲藏（hide的过去分词）
Highlight		n. 最精彩的部分；最重要的事情；加亮区;vt. 突出；强调；使显著；加亮
Highly		adv. 高度地；非常；非常赞许地
Hinder		n. (Hinder)人名；(芬)欣德;adj. 后面的;vt. 阻碍；打扰;vi. 成为阻碍
Hold		n. 控制；保留;n. (Hold)人名；(英、德、捷)霍尔德;vt. 持有；拥有；保存；拘留；约束或控制;vi. 支持；有效；持续
Horizontal		n. 水平线，水平面；水平位置;adj. 水平的；地平线的；同一阶层的
hospital		n. 医院;n. (Hospital)人名；(英)霍斯皮特尔
Host		n. 圣体；圣饼；圣餐面包
humanistic		adj. 人文主义的；人道主义的
Hundredth		n. 第一百，第一百个；百分之一;adj. 第一百的；一百分之一的
Hunt		n. 狩猎；搜寻;n. (Hunt)人名；(德、瑞典)洪特；(英)亨特；(法)安;vt. 打猎；搜索;vi. 打猎；搜寻
Hunter		n. 猎户座；亨特（姓氏）
hypothesis		n. 假设
ideal		n. 理想；典范;adj. 理想的；完美的；想象的；不切实际的
Identity		n. 身份；同一性，一致；特性；恒等式
Ignorance		n. 无知，愚昧；不知，不懂
Ignore		vt. 驳回诉讼；忽视；不理睬
Illegal		n. 非法移民；间谍;adj. [法] 非法的；违法的；违反规则的
Illness		n. 病；疾病
illustrate		vi. 举例;vt. 阐明，举例说明；图解
illustration		n. 说明；插图；例证；图解
Image		n. 影像；想象；肖像；偶像;n. (Image)人名；(法)伊马热;vt. 想象；反映；象征；作…的像
Imagination		n. [心理] 想象力；空想；幻想物
Imaginative		adj. 虚构的；富于想像的；有创造力的
Imbalance		n. 不平衡；不安定
Immediate		adj. 立即的；直接的；最接近的
Immediately		conj. 一…就;adv. 立即，立刻；直接地
Immense		adj. 巨大的，广大的；无边无际的；非常好的
Immune		n. 免疫者；免除者;adj. 免疫的；免于……的，免除的
Impact		n. 影响；效果；碰撞；冲击力;vt. 影响；撞击；冲突；压紧;vi. 冲击；产生影响
Implement		n. 工具，器具；手段;vt. 实施，执行；实现，使生效
Implication		n. 含义；暗示；牵连，卷入
Import		n. 进口，进口货；输入；意思，含义；重要性;vt. 输入，进口；含…的意思;vi. 输入，进口
Importance		n. 价值；重要；重大；傲慢
important		adj. 重要的，重大的；有地位的；有权力的
Impose		vt. 强加；征税；以…欺骗;vi. 利用；欺骗；施加影响
Impress		n. 印象，印记；特征，痕迹;vt. 盖印；强征；传送；给予某人深刻印象;vi. 给人印象
Impression		n. 印象；效果，影响；压痕，印记；感想
Impressive		adj. 感人的；令人钦佩的；给人以深刻印象的
Improve		vt. 改善，增进；提高…的价值;vi. 增加；变得更好
Improvement		n. 改进，改善
in addition		另外，此外
in general		总之，通常；一般而言
in terms of		依据；按照；在…方面；以…措词
inadequate		adj. 不充分的，不适当的
Incentive		n. 动机；刺激;adj. 激励的；刺激的
Incidence		n. 发生率；影响；[光] 入射；影响范围
incidentally		adv. 顺便；偶然地；附带地
Include		vt. 包含，包括
Income		n. 收入，收益；所得
incompatible		n. 互不相容的人或事物;adj. 不相容的；矛盾的；不能同时成立的
incorporate		vt. 包含，吸收；体现；把……合并;adj. 合并的；一体化的；组成公司的;vi. 合并；混合；组成公司
Increase		n. 增加，增长；提高;n. (Increase)人名；(英)英克里斯;vt. 增加，加大;vi. 增加，增大；繁殖
increasingly		adv. 越来越多地；渐增地
incredible		adj. 难以置信的，惊人的
Indeed		adv. 的确；实在；真正地；甚至;int. 真的（表示惊讶、怀疑、讽刺等）
independence		n. 独立性，自立性；自主
independent		n. 独立自主者；无党派者;adj. 独立的；单独的；无党派的；不受约束的
Indicate		vt. 表明；指出；预示；象征
indication		n. 指示，指出；迹象；象征
Indicator		n. 指示器；[试剂] 指示剂；[计] 指示符；压力计
indigenous		adj. 本土的；土著的；国产的；固有的
indirect		adj. 间接的；迂回的；非直截了当的
individual		n. 个人，个体;adj. 个人的；个别的；独特的
Industrial		n. 工业股票；工业工人;adj. 工业的，产业的；从事工业的；供工业用的；来自勤劳的
industrualise		industrualise
industry		n. 产业；工业；勤勉
Inevitably		adv. 不可避免地；必然地
Infant		n. 婴儿；幼儿；未成年人;n. (Infant)人名；(英)因方特;adj. 婴儿的；幼稚的；初期的；未成年的
infection		n. 感染；传染；影响；传染病
influence		n. 影响；势力；感化；有影响的人或事;vt. 影响；改变
Informal		adj. 非正式的；不拘礼节的；通俗的；日常使用的
Information		n. 信息，资料；知识；情报；通知
Inhabitant		n. 居民；居住者
Inherit		vt. 继承；遗传而得;vi. 成为继承人
initial		n. 词首大写字母;adj. 最初的；字首的;vt. 用姓名的首字母签名
Initially		adv. 最初，首先；开头
Initiative		n. 主动权；首创精神;adj. 主动的；自发的；起始的
Injury		n. 伤害，损害；受伤处
Innovative		adj. 革新的，创新的
input		n. 投入；输入电路;vt. [自][电子] 输入；将…输入电脑
Insect		n. 昆虫；卑鄙的人
Insight		n. 洞察力；洞悉;n. (Insight)人名；(英)因赛特
Insist		vt. 坚持，强调;vi. 坚持，强调
Inspect		vt. 检查；视察；检阅;vi. 进行检查；进行视察
Inspection		n. 视察，检查
Install		vt. 安装；任命；安顿
instance		n. 实例；情况；建议;vt. 举...为例
Instant		n. 瞬间；立即；片刻;adj. 立即的；紧急的；紧迫的
instantly		conj. 一…就…;adv. 立即地；马上地；即刻地
Instead		adv. 代替；反而
Instead of		代替；不是…而是…
Instruction		n. 指令，命令；指示；教导；用法说明
Instrument		n. 仪器；工具；乐器；手段；器械
Insurance		n. 保险；保险费；保险契约；赔偿金
Intake		n. 摄取量；通风口；引入口；引入的量
Integrate		n. 一体化；集成体;adj. 整合的；完全的;vt. 使…完整；使…成整体；求…的积分；表示…的总和;vi. 求积分；取消隔离；成为一体
intelligence		n. 智力；情报工作；情报机关；理解力
Intelligent		adj. 智能的；聪明的；理解力强的
Intend		vt. 打算；想要；意指;vi. 有打算
Intense		adj. 强烈的；紧张的；非常的；热情的
Intensely		adv. 强烈地；紧张地；热情地
Intensive		n. 加强器;adj. 加强的；集中的；透彻的；加强语气的
interact		n. 幕间剧；幕间休息;vt. 互相影响；互相作用;vi. 互相影响；互相作用
Interaction		n. 相互作用；[数] 交互作用;n. 互动
Interest		n. 兴趣，爱好；利息；趣味；同行;vt. 使……感兴趣；引起……的关心；使……参与
Interfere		vt. 冲突；介入;vi. 干涉；妨碍；打扰
Internal		adj. 内部的；内在的；国内的
international		n. 国际组织；国际体育比赛；外国居留者；国际股票;adj. 国际的；两国（或以上）国家的；超越国界的；国际关系的；世界的
Interpret		vt. 说明；口译;vi. 解释；翻译
interpretation		n. 解释；翻译；演出
interruption		n. 中断；干扰；中断之事
Interval		n. 间隔；间距；幕间休息
Intimate		n. 知己；至交;adj. 亲密的；私人的；精通的；有性关系的;vt. 暗示；通知；宣布
Introduce		vt. 介绍；引进；提出；采用
introduction		n. 介绍；引进；采用；入门；传入
introspection		n. 内省；反省
Invention		n. 发明；发明物；虚构；发明才能
Invention		n. 发明；发明物；虚构；发明才能
Invest		vt. 投资；覆盖；耗费；授予；包围;vi. 投资，入股；花钱买
Investigate		v. 调查；研究
investigation		n. 调查；调查研究
Investment		n. 投资；投入；封锁
invoke		vt. 调用；祈求；引起；恳求
involve		vt. 包含；牵涉；使陷于；潜心于
Involvement		n. 牵连；包含；混乱；财政困难
Ironical		adj. 讽刺的（等于ironic）；用反语的
Irony		n. 讽刺；反语；具有讽刺意味的事;adj. 铁的；似铁的
Irregular		n. 不规则物；不合规格的产品;adj. 不规则的；无规律的；非正规的；不合法的
irresistible		adj. 不可抵抗的；不能压制的；极为诱人的
Irrigate		vt. 灌溉；冲洗；使清新;vi. 灌溉；冲洗
Island		n. 岛；岛屿；安全岛；岛状物;n. (Island)人名；(英)艾兰;adj. 岛的;vt. 孤立；使成岛状
Isolate		n. [生物] 隔离种群;adj. 隔离的；孤立的;vt. 使隔离；使孤立；使绝缘;vi. 隔离；孤立
Isolation		n. 隔离；孤立；[电] 绝缘；[化学] 离析
Issue		n. 问题；流出；期号；发行物;vt. 发行，发布；发给；放出，排出;vi. 发行；流出；造成…结果；传下
Join		n. 结合；连接；接合点;n. (Join)人名；(法)茹安;vt. 参加；结合；连接;vi. 加入；参加；结合
Joint		n. 关节；接缝；接合处，接合点；（牛，羊等的腿）大块肉;n. (Joint)人名；(法)茹安;adj. 共同的；连接的；联合的，合办的;vt. 连接，贴合；接合；使有接头;vi. 贴合；生节
Journal		n. 日报，杂志；日记；分类账
Judge		n. 法官；裁判员;n. (Judge)人名；(英)贾奇;vt. 判断；审判;vi. 审判；判决
Judgement		n. 意见；判断力；[法] 审判；评价
Juvenile		n. 青少年；少年读物;adj. 青少年的；幼稚的
Keen		n. 痛哭，挽歌;n. (Keen)人名；(英)基恩；(德)肯；(肯)金;adj. 敏锐的，敏捷的；渴望的；强烈的；热心的；锐利的
Key		n. （打字机等的）键；关键；钥匙;n. (Key)人名；(英)基；(德、荷、瑞典)凯;adj. 关键的;vt. 键入；锁上；调节…的音调；提供线索;vi. 使用钥匙
Knowledge		n. 知识，学问；知道，认识；学科;n. (Knowledge)人名；(南非)诺利奇
Label		n. 标签；商标；签条;n. (Label)人名；(法)拉贝尔;vt. 标注；贴标签于
Laboratory		n. 实验室，研究室
Labour		n. （英国）工党
labour-intensive		adj. 劳动密集型的
Lack		n. 缺乏；不足;n. (Lack)人名；(老)拉；(英、法、意、葡、匈)拉克；(匈)洛克;vt. 缺乏；不足；没有；需要;vi. 缺乏；不足；没有
Largely		adv. 主要地；大部分；大量地
large-scale		adj. 大规模的，大范围的；大比例尺的
Last		n. 末尾，最后；上个；鞋楦（做鞋的模型）;n. (Last)人名；(英、德、葡、罗、瑞典)拉斯特;adj. 最后的；最近的，最新的；仅剩的；最不可能…的;vt. 度过，拖过；使维持;adv. 最后地；上次，最近；最后一点;vi. 持续；维持，够用；持久
Lately		adv. 近来，不久前
Latest		n. 最新的事物;adj. 最新的，最近的；最迟的;vt. 最新地
Lead		n. 领导；铅；导线；榜样;n. (Lead)人名；(英)利德;adj. 带头的；最重要的;vt. 领导；致使；引导；指挥;vi. 领导；导致；用水砣测深
Leading		n. 领导；铅板；行距;adj. 领导的；主要的;v. 领导（lead的ing形式）
Learn		vt. 学习；得知；认识到;vi. 学习；获悉
Least		n. 最小；最少;adj. 最小的；最少的（little的最高级）;adv. 最小；最少
Leave		n. 许可，同意；休假;vt. 离开；留下；遗忘；委托;vi. 离开，出发；留下
Lecture		n. 演讲；讲稿；教训;vt. 演讲；训诫;vi. 讲课；讲演
Leisure		n. 闲暇；空闲；安逸;n. (Leisure)人名；(英)莱热;adj. 空闲的；有闲的；业余的
Length		n. 长度，长；时间的长短；（语）音长
level		n. 水平；标准；水平面;adj. 水平的；平坦的；同高的;vt. 使同等；对准；弄平;vi. 瞄准；拉平；变得平坦;n. (Level)人名；(法)勒韦尔
Lifestyle		n. 生活方式;保健的
likely to		可能
limit		n. 限制；限度；界线;vt. 限制；限定
Limitation		n. 限制；限度；极限；追诉时效；有效期限
Linguist		n. 语言学家;学多种外语的人
linguistic		adj. 语言的；语言学的
link		n. [计] 链环，环节；联系，关系;vt. 连接，连结；联合，结合;vi. 连接起来；联系在一起；将人或物连接或联系起来;n. (Link)人名；(英、德、塞、捷、匈、瑞典)林克
link to		链接到；把…和…连接；把…和…联系起来
literacy		n. 读写能力；精通文学
literal		adj. 文字的；逐字的；无夸张的
literature		n. 文学；文献；文艺；著作
Load		n. 负载，负荷；工作量；装载量;vt. 使担负；装填;vi. [力] 加载；装载；装货
Loan		n. 贷款；借款;vt. 借；借给;vi. 借出
Local		n. [计] 局部；当地居民；本地新闻;adj. 当地的；局部的；地方性的；乡土的
Locate		vt. 位于；查找…的地点;vi. 定位；定居
location		n. 位置（形容词locational）；地点；外景拍摄场地
Lock		n. 锁；水闸；刹车;n. (Lock)人名；(英、丹、德、瑞典)洛克;vt. 锁，锁上；隐藏;vi. 锁；锁住；卡住
Log		n. 记录；航行日志；园木;vt. 切；伐木；航行;vi. 伐木;n. (Log)人名；(蒙)洛格
Logically		adv. 逻辑上；合乎逻辑
long-term		adj. 长期的;从长远来看
Loose		n. 放纵；放任；发射;n. (Loose)人名；(捷、瑞典)洛塞；(英)卢斯；(德)洛泽;adj. 宽松的；散漫的；不牢固的；不精确的;vt. 释放；开船；放枪;adv. 松散地;vi. 变松；开火
Loss		n. 减少；亏损；失败；遗失;n. (Loss)人名；(匈)洛什；(法、德、意)洛斯
Loyalty		n. 忠诚；忠心；忠实
Machinery		n. 机械；机器；机构；机械装置
Magnificent		adj. 高尚的；壮丽的；华丽的；宏伟的
magnify		vt. 放大；赞美；夸大;vi. 放大；有放大能力
Main		n. 主要部分，要点；体力；总管道;n. (Main)人名；(德)迈因；(西)马因；(英、法)梅因;adj. 主要的，最重要的；全力的
Mainly		adv. 主要地，大体上
Mainstream		n. 主流
Maintain		vt. 维持；继续；维修；主张；供养
Maintenance		n. 维护，维修；保持；生活费用
Major		n. [人类] 成年人；主修科目；陆军少校;n. (Major)人名；(西)马霍尔；(法)马若尔；(捷、德、塞、瑞典)马约尔；(英)梅杰;adj. 主要的；重要的；主修的；较多的;vi. 主修
Majority		n. 多数；成年
make up		组成；补足；化妆；编造
Mammal		n. [脊椎] 哺乳动物
manage		vt. 管理；经营；控制；设法;vi. 处理；应付过去
Manifest		n. 载货单，货单；旅客名单;adj. 显然的，明显的；明白的;vt. 证明，表明；显示;vi. 显示，出现
Manipulate		vt. 操纵；操作；巧妙地处理；篡改
Manner		n. 方式；习惯；种类；规矩；风俗;n. (Manner)人名；(德、芬、瑞典)曼纳
Manufacture		n. 制造；产品；制造业;vt. 制造；加工；捏造;vi. 制造
marathon		n. 马拉松赛跑；耐力的考验;adj. 马拉松式的；有耐力的;vi. 参加马拉松赛跑
Mark		n. 标志；马克；符号；痕迹;n. (Mark)人名；(老)马;vt. 标志；做标记于；打分数;vi. 作记号
Market		n. 市场；行情；股票市场；市面；集市；销路；商店;n. (Market)人名；(塞)马尔凯特;vt. 在市场上出售;vi. 做买卖
Mass		n. 块，团；群众，民众；大量，众多;adj. 群众的，民众的；大规模的，集中的;vt. 使集合;vi. 聚集起来，聚集;n. (Mass)人名；(法、俄)马斯
mass media		大众传播媒体
massive		adj. 大量的；巨大的，厚重的；魁伟的
Master		n. 硕士；主人；大师；教师;n. (Master)人名；(英)马斯特;adj. 主人的；主要的；熟练的;vt. 控制；精通；征服
Masterpiece		n. 杰作；绝无仅有的人
Match		n. 比赛，竞赛；匹配；对手；火柴;vt. 使比赛；使相配；敌得过，比得上；相配；与…竞争;vi. 比赛；匹配；相配，相称；相比
Mate		n. 助手，大副；配偶；同事；配对物;n. (Mate)人名；(日)蛏(姓)；(西、意、塞)马特；(波黑)马特；(罗、俄)马泰;vt. 使配对；使一致；结伴;vi. 交配；成配偶；紧密配合
material		n. 材料，原料；物资；布料;adj. 重要的；物质的，实质性的；肉体的
Math		n. 数学（等于mathematics）;n. (Math)人名；(德)马特；(柬)马；(英)马思
Mathematical		adj. 数学的，数学上的；精确的
maximum		n. [数] 极大，最大限度；最大量;adj. 最高的；最多的；最大极限的
Mean		n. 平均值;n. (Mean)人名；(柬)棉;adj. 平均的；卑鄙的；低劣的;vt. 意味；想要；意欲;vi. 用意
Means		n. 手段；方法；财产（mean的复数）;v. 意思是；打算（mean的第三人称单数）;n. (Means)人名；(英)米恩斯
Measure		n. 测量；措施；程度；尺寸;vt. 测量；估量；权衡;vi. 测量；估量
Measurement		n. 测量；[计量] 度量；尺寸；量度制
Mechanical		adj. 机械的；力学的；呆板的；无意识的；手工操作的
media		n. 媒体；媒质（medium的复数）；血管中层；浊塞音；中脉
medical		n. 医生；体格检查;adj. 医学的；药的；内科的
Medicine		n. 药；医学；内科；巫术;vt. 用药物治疗；给…用药
Medium		n. 方法；媒体；媒介；中间物;adj. 中间的，中等的；半生熟的
Melt		n. 熔化；熔化物;vt. 使融化；使熔化；使软化；使感动;vi. 熔化，溶解；渐混
member		n. 成员；会员；议员
Memorable		adj. 显著的，难忘的；值得纪念的
Memorise		vt. （英）记忆；存储（等于memorize）
Mental		n. 精神病患者;adj. 精神的；脑力的；疯的
mention		n. 提及，说起;vt. 提到，谈到；提及，论及；说起;n. (Mention)人名；(法)芒雄
Mere		n. 小湖；池塘;n. (Mere)人名；(日)目连(姓)；(西)梅雷;adj. 仅仅的；只不过的
Merely		adv. 仅仅，只不过；只是
Message		n. 消息；差使；启示；预言；广告词;vt. 通知;vi. 报信，报告；[通信] 报文
Metal		n. 金属；合金;n. (Metal)人名；(捷)梅塔尔；(瑞典)梅塔尔;adj. 金属制的;vt. 以金属覆盖
method		n. 方法；条理；类函数;adj. 使用体验派表演方法的
methodology		n. 方法学，方法论
Micro		adj. 微小的;n. 微米;n. (Micro)人名；(瑞典)米克罗
migration		n. 迁移；移民；移动
Military		n. 军队；军人;adj. 军事的；军人的；适于战争的
Mimic		n. 效颦者，模仿者；仿制品；小丑;adj. 模仿的，模拟的；假装的;vt. 模仿，摹拟
Minimal		adj. 最低的；最小限度的
Minimize		vt. 使减到最少；小看，极度轻视;vi. 最小化
minority		n. 少数民族；少数派；未成年;adj. 少数的；属于少数派的
Minute		n. 分，分钟；片刻，一会儿；备忘录，笔记；会议记录;adj. 微小的，详细的;vt. 将…记录下来
misconception		n. 误解；错觉；错误想法
Mislead		vt. 误导；带错
Mistake		n. 错误；误会；过失;vt. 弄错；误解;vi. 弄错；误解
mistaken		v. 弄错（mistake的过去分词）;adj. 错误的；弄错的；被误解的
mobility		n. 移动性；机动性；[电子] 迁移率
Model		n. 模型；典型；模范；模特儿；样式;n. (Model)人名；(德、俄、英)莫德尔;adj. 模范的；作模型用的;vt. 模拟；塑造；模仿;vi. 做模型；做模特儿
modern		n. 现代人；有思想的人;adj. 现代的，近代的；时髦的
Modest		n. (Modest)人名；(罗)莫代斯特；(德)莫德斯特；(俄)莫杰斯特;adj. 谦虚的，谦逊的；适度的；端庄的；羞怯的
modification		n. 修改，修正；改变
Modify		vt. 修改，修饰；更改;vi. 修改
Moment		n. 重要，契机；瞬间；重要时刻；指定时刻;n. (Moment)人名；(英)莫门特
Monitor		n. 监视器；监听器；监控器；班长;vt. 监控;n. (Monitor)人名；(德)莫尼托
Mood		n. 情绪，语气；心境；气氛;n. (Mood)人名；(英)穆德；(瑞典)莫德
moral		n. 道德；寓意;adj. 道德的；精神上的；品性端正的;n. (Moral)人名；(德、法、西、葡、土)莫拉尔
mortality		n. 死亡数，死亡率；必死性，必死的命运
Mostly		adv. 主要地；通常；多半地
Motion		n. 动作；移动；手势；请求；意向;vt. 运动；向…打手势;vi. 运动；打手势
Motivate		vt. 刺激；使有动机；激发…的积极性
motivation		n. 动机；积极性；推动
Motive		n. 动机，目的；主题;adj. 发动的；成为动机的;vt. 使产生动机，激起
Mould		n. 模具；霉;n. (Mould)人名；(英)莫尔德;vt. 浇铸；用泥土覆盖;vi. 发霉
Movement		n. 运动；活动；运转；乐章
Multiply		adj. 多层的；多样的;vt. 乘；使增加；使繁殖；使相乘;adv. 多样地；复合地;vi. 乘；繁殖；增加
Narrow		n. 海峡；狭窄部分，隘路;adj. 狭窄的，有限的；勉强的；精密的；度量小的;vt. 使变狭窄;vi. 变窄
Native		n. 本地人；土产；当地居民;adj. 本国的；土著的；天然的；与生俱来的；天赋的
natural		n. 自然的事情；白痴；本位音;adj. 自然的；物质的；天生的；不做作的;n. (Natural)人名；(西)纳图拉尔
Nature		n. 自然；性质；本性；种类;n. (Nature)人名；(法)纳蒂尔
necessary		n. 必需品;adj. 必要的；必需的；必然的;n. (Necessary)人名；(英)内塞瑟里
Negative		n. 否定；负数；[摄] 底片;adj. [数] 负的；消极的；否定的；阴性的;vt. 否定；拒绝
negatively		adv. 消极地；否定地
neighbour		n. n. 邻居;同胞；仁慈的人;adj. 邻居的；邻近的;vt. 邻接;vi. 住在邻近；毗邻；友善，和睦
Nervous		adj. 神经的；紧张不安的；强健有力的
Network		n. 网络；广播网；网状物
Nevertheless		conj. 然而，不过;adv. 然而，不过；虽然如此
Noise		n. [环境] 噪音；响声；杂音;n. (Noise)人名；(英)诺伊斯;vt. 谣传;vi. 发出声音；大声议论
non-specific		adj. 不明确的；非确切的
non-verbal		adj. 非语言的；非用言语的
Normal		n. 正常；标准；常态;n. (Normal)人名；(德)诺马尔;adj. 正常的；正规的，标准的
Normally		adv. 正常地；通常地，一般地
Notable		n. 名人，显要人物;adj. 值得注意的，显著的；著名的
Note		n. 笔记；音符；票据；注解；纸币；便笺；照会；调子;n. (Note)人名；(英)诺特;vt. 注意；记录；注解
Notice		n. 通知，布告；注意；公告;vt. 通知；注意到；留心;vi. 引起注意
Notion		n. 概念；见解；打算
nourish		vt. 滋养；怀有；使健壮
Nutrient		n. 营养物；滋养物;adj. 营养的；滋养的
nutrition		n. 营养，营养学；营养品
Object		n. 目标；物体；客体；宾语;vt. 提出…作为反对的理由;vi. 反对；拒绝
Objection		n. 异议，反对；缺陷，缺点；妨碍；拒绝的理由
objective		n. 目的；目标；[光] 物镜；宾格;adj. 客观的；目标的；宾格的
Obligation		n. 义务；职责；债务
Observation		n. 观察；监视；观察报告
Observe		vt. 观察；遵守；说；注意到；评论;vi. 观察；说；注意到；评论
Obstacle		n. 障碍，干扰；妨害物
Obstruct		vt. 妨碍；阻塞；遮断;vi. 阻塞；设障碍
Obtain		vt. 获得;vi. 获得；流行
obvious		adj. 明显的；显著的；平淡无奇的
obviously		adv. 明显地;显然地
Occasion		n. 时机，机会；场合；理由;vt. 引起，惹起
Occupy		vt. 占据，占领；居住；使忙碌
occur		vi. 发生；出现；存在
Ocean		n. 海洋；大量；广阔;n. (Ocean)人名；(罗)奥切安
Odd		n. 奇数；怪人；奇特的事物;n. (Odd)人名；(英、西、挪、瑞典)奥德;adj. 奇数的；古怪的；剩余的；临时的；零散的
Odour		n. 气味；声誉
offender		n. 罪犯；冒犯者；违法者
Offer		n. 提议；出价；意图；录取通知书;vt. 提供；出价；试图;vi. 提议；出现；献祭；求婚
operation		n. 操作；经营；[外科] 手术；[数][计] 运算
Operator		n. 经营者；操作员；话务员；行家
Opinion		n. 意见；主张
opportunity		n. 时机，机会
Oppose		vt. 反对；对抗，抗争;vi. 反对
Opposite		n. 对立面；反义词;prep. 在…的对面;adj. 相反的；对面的；对立的;adv. 在对面
Opposition		n. 反对；反对派；在野党；敌对
optimism		n. 乐观；乐观主义
Optimistic		adj. 乐观的；乐观主义的
Optimum		n. 最佳效果；最适宜条件;adj. 最适宜的
Option		n. [计] 选项；选择权；买卖的特权
Oral		n. 口试;n. (Oral)人名；(土)奥拉尔;adj. 口头的，口述的
Order		n. 命令；顺序；规则；[贸易] 定单;vt. 命令；整理；定购;vi. 命令；定货
ordinary		n. 普通；平常的人（或事）;adj. 普通的；平凡的；平常的
Organic		adj. [有化] 有机的；组织的；器官的；根本的
Organize		vt. 组织；使有系统化；给予生机；组织成立工会等;vi. 组织起来；成立组织
organization		n. 组织；机构；体制；团体
Organize		vt. 组织；使有系统化；给予生机；组织成立工会等;vi. 组织起来；成立组织
Origin		n. 起源；原点；出身；开端
Original		n. 原件；原作；原物；原型;adj. 原始的；最初的；独创的；新颖的
originality		n. 创意；独创性，创造力；原始；新奇
originate		vi. 发源；发生；起航;vt. 引起；创作
otherwise		adj. 另外的；其他方面的;adv. 否则；另外；在其他方面
outcome		n. 结果，结局；成果
outline		n. 轮廓；大纲；概要；略图;vt. 概述；略述；描画…轮廓
Outlook		n. 展望；观点；景色;vt. 比……好看；用目光压倒;vi. 朝外看
Output		n. 输出，输出量；产量；出产;vt. 输出
Overall		n. 工装裤；罩衫;adj. 全部的；全体的；一切在内的;adv. 全部地；总的说来
Overcome		vt. 克服；胜过;vi. 克服；得胜
overlap		n. 重叠；重复;vt. 与…重叠；与…同时发生;vi. 部分重叠；部分的同时发生
Overlook		n. 忽视；眺望;vt. 忽略；俯瞰；远眺；检查；高耸于…之上
Oversee		vt. 监督；审查；俯瞰；偷看到，无意中看到
Overtake		vt. 赶上；压倒；突然来袭;vi. 超车
Overview		n. [图情] 综述；概观
overwhelmingly		adv. 压倒性地；不可抵抗地
Own		n. 自己的;n. (Own)人名；(阿拉伯)奥恩;adj. 自己的；特有的;vt. 拥有；承认;vi. 承认
Oxygen		n. [化学] 氧气，[化学] 氧
Pace		n. 一步；步速；步法;n. (Pace)人名；(捷)帕采；(英)佩斯；(法)帕斯；(罗)帕切;vt. 踱步于；用步测;vi. 踱步；缓慢而行
painstaking		n. 辛苦；勤勉;adj. 艰苦的；勤勉的；小心的
Pair		n. 一对，一双，一副;n. (Pair)人名；(英、法)佩尔;vt. 把…组成一对
participant		n. 参与者；关系者;adj. 参与的；有关系的
participate		vi. 参与，参加；分享;vt. 分享；分担;[ 过去式participated 过去分词participated 现在分词participating ]
participation		n. 参与；分享；参股
particular		n. 详细说明；个别项目;adj. 特别的；详细的；独有的；挑剔的
particularly		adv. 特别地，独特地；详细地，具体地；明确地，细致地
Partner		n. 伙伴；合伙人；配偶;n. (Partner)人名；(英、德)帕特纳;vt. 使合作；与…合伙;vi. 合伙；合股；成为搭档
Passion		n. 耶稣受难记；耶稣受难的艺术或音乐作品
Past		n. 过去；往事;prep. 越过；晚于;adj. 过去的；结束的;adv. 过；经过
patient		n. 病人；患者;adj. 有耐性的，能容忍的;n. (Patient)人名；(法)帕蒂安
Pattern		n. 模式；图案；样品;vt. 模仿；以图案装饰;vi. 形成图案
pay		n. 工资，薪水；付款；报答;vt. 支付，付；偿还，补偿；给予;vi. 付款；偿还;adj. 收费的；需付费的
Peak		n. 山峰；最高点；顶点；帽舌;n. (Peak)人名；(英)皮克;adj. 最高的；最大值的;vt. 使达到最高点；使竖起;vi. 消瘦；到达最高点；变憔悴
Peer		n. 贵族；同等的人;n. (Peer)人名；(英、巴基)皮尔;vt. 封为贵族；与…同等;vi. 凝视，盯着看；窥视
Perceive		vt. 察觉，感觉；理解；认知;vi. 感到，感知；认识到
percentage		n. 百分比；百分率，百分数
perception		n. 知觉；[生理] 感觉；看法；洞察力；获取
Perfect		n. 完成式;n. (Perfect)人名；(英)珀费克特;adj. 完美的；最好的；精通的;vt. 使完美；使熟练
Perform		vt. 执行；完成；演奏;vi. 执行，机器运转；表演
performance		n. 性能；绩效；表演；执行
perhaps		n. 假定；猜想；未定之事;adv. 或许；（表示不确定）也许；（用于粗略的估计）或许；（表示勉强同意或其实不赞成）也许；可能
Perimeter		n. 周长；周界；[眼科] 视野计
Period		n. 周期，期间；时期；月经；课时；（语法学）句点，句号;adj. 某一时代的
permanent		n. 烫发（等于permanent wave）;adj. 永久的，永恒的；不变的
Permission		n. 允许，许可
Permit		n. 许可证，执照;vt. 许可；允许;vi. 许可；允许
Persist		vt. 坚持说，反复说;vi. 存留，坚持；持续，固执
Persistent		adj. 固执的，坚持的；持久稳固的
Personal		n. 人事消息栏；人称代名词;adj. 个人的；身体的；亲自的
Personality		n. 个性；品格；名人
personnel		n. 人事部门；全体人员;adj. 人员的；有关人事的
Perspective		n. 观点；远景；透视图;adj. 透视的
persuade		vt. 说服，劝说；使某人相信；劝某人做（不做）某事;adj. 空闲的，有闲的;vi. 说服；被说服
Pessimistic		adj. 悲观的，厌世的；悲观主义的
Pesticide		n. 杀虫剂
Phase		n. 相；阶段；[天] 位相;vt. 使定相；逐步执行;vi. 逐步前进
Phenomenon		n. 现象；奇迹；杰出的人才
Photograph		n. 照片，相片;vt. 为…拍照；使深深印入;vi. 拍照；在照片上显得
Physical		n. 体格检查;adj. [物] 物理的；身体的；物质的
Pioneer		n. 先锋；拓荒者;vt. 开辟；倡导；提倡;vi. 作先驱
Planet		n. 行星;n. (Planet)人名；(法)普拉内；(西、葡)普拉内特
Plant		n. 工厂，车间；植物；设备；庄稼;n. (Plant)人名；(英、西、意)普兰特；(法)普朗;vt. 种植；培养；栽培；安置;vi. 种植
plenty of		大量；很多；许多
Plight		n. 困境；境况；誓约;vt. 保证；约定
Plot		n. 情节；图；阴谋;n. (Plot)人名；(捷)普洛特；(法)普洛;vt. 密谋；绘图；划分；标绘;vi. 密谋；策划；绘制
plyometric		plyometric
policy		n. 政策，方针；保险单
political		adj. 政治的；党派的
Pollute		vt. 污染；玷污；败坏
pollution		n. 污染;污染物
popularity		n. 普及，流行；名气；受大众欢迎
population		n. 人口；[生物] 种群，[生物] 群体；全体居民
Portion		n. 部分；一份；命运;vt. 分配；给…嫁妆
Pose		vi. 摆姿势；佯装；矫揉造作;v. 造成，形成；摆姿势；装模作样；提出…讨论;n. 姿势，姿态；装模作样;n. (Pose)人名；(西)波塞；(德)波泽
Positive		n. 正数；[摄] 正片;adj. 积极的；[数] 正的，[医][化学] 阳性的；确定的，肯定的；实际的，真实的；绝对的
possess		vt. 控制；使掌握；持有；迷住；拥有，具备
possibility		n. 可能性；可能发生的事物
Possible		n. 可能性；合适的人；可能的事物;adj. 可能的；合理的；合适的
Postpone		vt. 使…延期；把…放在次要地位；把…放在后面;vi. 延缓，延迟；延缓发作
potential		n. 潜能；可能性；[电] 电势;adj. 潜在的；可能的；势的
potentially		adv. 可能地，潜在地
Pour		n. 倾泻；流出；骤雨;n. (Pour)人名；(伊朗)普尔；(捷)保尔;vt. 灌，注；倒；倾泻；倾吐;vi. 倾泻；涌流；斟茶
Poverty		n. 贫困；困难；缺少；低劣
Powder		n. 粉；粉末；[化工][军] 火药；尘土;vt. 使成粉末；撒粉；搽粉于;vi. 搽粉；变成粉末
power		n. 功率；力量；能力；政权；势力；[数] 幂;adj. 借影响有权势人物以操纵权力的;vt. 激励；供以动力；使…有力量;vi. 快速前进;n. (Power)人名；(英、葡)鲍尔
Powerful		adj. 强大的；强有力的;adv. 很；非常
practical		adj. 实际的；实用性的
Practice		n. 实践；练习；惯例;vt. 练习；实习；实行;vi. 练习；实习；实行
precaution		n. 预防，警惕；预防措施;vt. 警惕；预先警告
Precise		adj. 精确的；明确的；严格的
Predation		n. 捕食；掠夺
predict		vi. 作出预言；作预料，作预报;vt. 预报，预言；预知
predictable		adj. 可预言的
predominate		vt. 支配，主宰；在…中占优势;vi. 占主导（或支配）地位；占优势
Prefer		vt. 更喜欢；宁愿；提出；提升;vi. 喜欢；愿意
preference		n. 偏爱，倾向；优先权
Premature		n. 早产儿；过早发生的事物;adj. 早产的；不成熟的；比预期早的
preparation		n. 预备；准备
Prepare		vt. 准备；使适合；装备；起草;vi. 预备；做好思想准备
Prescribe		vt. 规定；开处方;vi. 规定；开药方
presence		n. 存在；出席；参加；风度；仪态
present		n. 现在；礼物；瞄准;adj. 现在的；出席的;vt. 提出；介绍；呈现；赠送;vi. 举枪瞄准
preservation		n. 保存，保留
Preserve		n. 保护区；禁猎地；加工成的食品;vt. 保存；保护；维持；腌；禁猎
Press		n. 压；按；新闻；出版社；[印刷] 印刷机;n. (Press)人名；(英、德、俄、西、瑞典)普雷斯;vt. 压；按；逼迫；紧抱;vi. 压；逼；重压
Pressure		n. 压力；压迫，[物] 压强;vt. 迫使；密封；使……增压
prevent		vt. 预防，防止；阻止;vi. 妨碍，阻止
preventable		adj. 可预防的；可阻止的；可防止的
prevention		n. 预防；阻止；妨碍
Previous		adj. 以前的；早先的；过早的;adv. 在先；在…以前
previously		adv. 以前；预先；仓促地
Prey		n. 捕食；牺牲者；被捕食的动物;n. (Prey)人名；(英、法)普雷；(德)普赖;vi. 捕食；掠夺；折磨
Price		n. 价格；价值；代价;n. (Price)人名；(英)普赖斯；(法)普里斯；(葡、瑞典)普里塞;vt. 给……定价；问……的价格
primary		n. 原色；最主要者;adj. 主要的；初级的；基本的
Primitive		n. 原始人;adj. 原始的，远古的；简单的，粗糙的
Principle		n. 原理，原则；主义，道义；本质，本义；根源，源泉
prior to		在……之前；居先
Priority		n. 优先；优先权；[数] 优先次序；优先考虑的事
Private		n. 列兵；二等兵;adj. 私人的；私有的；私下的
Probable		n. 很可能的事；大有希望的候选者;adj. 很可能的；可信的
procedure		n. 程序，手续；步骤
Proceed		vi. 开始；继续进行；发生；行进
process		n. 过程，进行；方法，步骤；作用；程序；推移;adj. 经过特殊加工（或处理）的;vt. 处理；加工;vi. 列队前进
produce		n. 农产品，产品;vt. 生产；引起；创作;vi. 生产，创作
producer		n. 制作人，制片人；生产者；发生器
product		n. 产品；结果；[数] 乘积；作品
production		n. 成果；产品；生产；作品
productivity		n. 生产力；生产率；生产能力
Profession		n. 职业，专业；声明，宣布，表白
professional		n. 专业人员；职业运动员;adj. 专业的；职业的；职业性的
Profit		n. 利润；利益;n. (Profit)人名；(法)普罗菲;vt. 有益于;vi. 获利；有益
Program		n. 程序；计划；大纲;vt. 用程序指令；为…制订计划；为…安排节目;vi. 编程序；安排节目；设计电脑程式
progress		n. 进步，发展；前进;vi. 前进，进步；进行;n. (Progress)人名；(赞)普罗格雷斯
Project		n. 工程；计划；事业;vt. 设计；计划；发射；放映;vi. 设计；计划；表达；投射
Prolong		vt. 延长；拖延
promising		v. 许诺，答应（promise的现在分词形式）;adj. 有希望的，有前途的
Promote		vt. 促进；提升；推销；发扬;vi. 成为王后或其他大于卒的子
promotion		n. 提升，[劳经] 晋升；推销，促销；促进；发扬，振兴
Prompt		n. 提示；付款期限；DOS命令：改变DOS系统提示符的风格;adj. 敏捷的，迅速的；立刻的;vt. 提示；促进；激起；（给演员）提白;adv. 准时地
property		n. 性质，性能；财产；所有权
proportion		n. 比例；部分；面积；均衡;vt. 使成比例；使均衡；分摊
proposal		n. 提议，建议；求婚
Propose		vt. 建议；打算，计划；求婚;vi. 建议；求婚；打算
prospect		n. 前途；预期；景色;vt. 勘探，勘察;vi. 勘探，找矿
protect		vt. 保护，防卫；警戒
protection		n. 保护；防卫；护照
protein		n. 蛋白质；朊;adj. 蛋白质的
prove		vi. 证明是;vt. 证明；检验；显示
provide		vt. 提供；规定；准备；装备;vi. 规定；抚养；作准备
psychological		adj. 心理的；心理学的；精神上的
psychologist		n. 心理学家，心理学者
psychology		n. 心理学；心理状态
public		n. 公众；社会；公共场所;adj. 公众的；政府的；公用的；公立的;n. (Public)人名；(英)帕布利克
Publish		vt. 出版；发表；公布;vi. 出版；发行；刊印
Pump		n. 泵，抽水机；打气筒;n. (Pump)人名；(捷)蓬普；(英)庞普;vt. 打气；用抽水机抽…;vi. 抽水
Punish		vt. 惩罚；严厉对待；贪婪地吃喝;vi. 惩罚
pupil		n. 学生；[解剖] 瞳孔；未成年人
Pure		n. (Pure)人名；(俄)普雷;adj. 纯的；纯粹的；纯洁的；清白的；纯理论的
Purify		vt. 净化；使纯净;vi. 净化；变纯净
Purpose		n. 目的；用途；意志;vt. 决心；企图；打算
Pursue		vt. 继续；从事；追赶；纠缠;vi. 追赶；继续进行
pursuit		n. 追赶，追求；职业，工作
Puzzle		n. 谜；难题；迷惑;vt. 使…困惑；使…为难；苦思而得出;vi. 迷惑；冥思苦想
Qualify		vt. 限制；使具有资格；证明…合格;vi. 取得资格，有资格
Quality		n. 质量，[统计] 品质；特性；才能
Quantity		n. 量，数量；大量；总量
Questionnaire		n. 问卷；调查表
quite		adv. 很；相当；完全
Quotation		n. [贸易] 报价单；引用语；引证
Race		n. 属，种；种族，人种；家庭，门弟;n. (Race)人名；(英)雷斯；(塞)拉采;vt. 使参加比赛；和…竞赛；使急走，使全速行进;vi. 比速度，参加竞赛；全速行进
rainforest		n. （热带）雨林
Raise		n. 高地；上升；加薪;n. (Raise)人名；(英)雷兹;vt. 提高；筹集；养育；升起;vi. 上升
Random		n. 随意;adj. [数] 随机的；任意的；胡乱的;adv. 胡乱地
Range		n. 范围；幅度；排；山脉;vt. 漫游；放牧；使并列；归类于；来回走动;vi. 平行，列为一行；延伸；漫游；射程达到;n. (Range)人名；(葡)兰热；(瑞典、德)朗格
Rank		n. 排；等级；军衔；队列;n. (Rank)人名；(英、德、芬、捷)兰克;adj. 讨厌的；恶臭的；繁茂的;vt. 排列；把…分等;vi. 列为；列队
Rapid		n. 急流；高速交通工具，高速交通网;adj. 迅速的，急促的；飞快的；险峻的
Rapidly		adv. 迅速地；很快地；立即
Rare		adj. 稀有的；半熟的；稀薄的;adv. 非常；极其;vi. 用后腿站起；渴望
rarely		adv. 很少地；难得；罕有地
Rate		n. 比率，率；速度；价格；等级;n. (Rate)人名；(法、塞)拉特;vt. 认为；估价；责骂;vi. 责骂；被评价
Raw		n. 擦伤处;n. (Raw)人名；(英)罗;adj. 生的；未加工的；阴冷的；刺痛的；擦掉皮的；无经验的；（在艺术等方面）不成熟的;vt. 擦伤
raw material		[材] 原料
react		vi. 反应；影响；反抗；起反作用;vt. 使发生相互作用；使起化学反应
reaction		n. 反应，感应；反动，复古；反作用
Readily		adv. 容易地；乐意地；无困难地
realise		vt. 认识到，明白
Realistic		adj. 现实的；现实主义的；逼真的；实在论的
reality		n. 现实；实际；真实
Rear		n. 后面；屁股；后方部队;adj. 后方的；后面的；背面的;vt. 培养；树立；栽种;adv. 向后；在后面;vi. 暴跳；高耸
Reason		n. 理由；理性；动机;n. (Reason)人名；(英)里森;vt. 说服；推论；辩论;vi. 推论；劝说
reasonable		adj. 合理的，公道的；通情达理的
Recall		n. 召回；回忆；撤消;vt. 召回；回想起，记起；取消
Receive		vt. 收到；接待；接纳;vi. 接收
Recent		adj. 最近的；近代的
Recognize		vt. 认出，识别；承认;vi. 确认，承认；具结
Recommend		vt. 推荐，介绍；劝告；使受欢迎；托付;vi. 推荐；建议
record		n. 档案，履历；唱片；最高纪录;adj. 创纪录的;vt. 记录，记载；标明；将...录音;vi. 记录；录音;n. (Record)人名；(法)勒科尔；(英)雷科德
Recourse		n. 求援，求助；[经] 追索权；依赖；救生索
reduce		vi. 减少；缩小；归纳为;vt. 减少；降低；使处于；把…分解
Reduction		n. 减少；下降；缩小
refer		vt. 涉及；委托；归诸于；使…求助于;vi. 参考；涉及；提到；查阅
refer to		参考；涉及；指的是；适用于
Reference		n. 参考，参照；涉及，提及；参考书目；介绍信；证明书;vt. 引用;vi. 引用
Refine		vt. 精炼，提纯；改善；使…文雅
reflect		vt. 反映；反射，照出；表达；显示;反省;vi. 反射，映现；深思
Refuse		n. 垃圾；废物;vt. 拒绝；不愿；抵制;vi. 拒绝
Regard		n. 注意；尊重；问候；凝视;n. (Regard)人名；(西、意)雷加德；(法)勒加尔;vt. 注重，考虑；看待；尊敬；把…看作；与…有关;vi. 注意，注重；注视
regardless		adj. 不管；不顾；不注意
regardless of		不顾，不管
Region		n. 地区；范围；部位
Register		n. 登记；注册；记录；寄存器；登记簿;n. (Register)人名；(英)雷吉斯特;vt. 登记；注册；记录；挂号邮寄；把…挂号；正式提出;vi. 登记；注册；挂号
Regular		n. 常客；正式队员；中坚分子;n. (Regular)人名；(以)雷古拉尔;adj. 定期的；有规律的；合格的；整齐的；普通的;adv. 定期地；经常地
Regularly		adv. 定期地；有规律地；整齐地；匀称地
regulate		vt. 调节，规定；控制；校准；有系统的管理
regulation		n. 管理；规则；校准;adj. 规定的；平常的
rehearsal		n. 排演；预演；练习；训练；叙述
reject		n. 被弃之物或人；次品;vt. 拒绝；排斥；抵制；丢弃
relate		vt. 叙述；使…有联系;vi. 涉及；认同；符合；与…有某种联系
relate to		涉及，有关
Relation		n. 关系；叙述；故事；亲属关系
relationship		n. 关系；关联
Relative		n. 亲戚；相关物；[语] 关系词；亲缘植物;adj. 相对的；有关系的；成比例的
relatively		adv. 相当地；相对地，比较地
Release		n. 释放；发布；让与;vt. 释放；发射；让与；允许发表
Relevant		adj. 有关的；中肯的；有重大作用的
Reliable		n. 可靠的人;adj. 可靠的；可信赖的
Reliance		n. 信赖；信心；受信赖的人或物
Relief		n. 救济；减轻，解除；安慰
Religious		n. 修道士；尼姑;adj. 宗教的；虔诚的；严谨的；修道的
Rely		vi. 依靠；信赖
Remain		n. 遗迹；剩余物，残骸;vi. 保持；依然；留下；剩余；逗留；残存
Remark		n. 注意；言辞;vt. 评论；觉察;vi. 谈论
remarkable		adj. 卓越的；非凡的；值得注意的
Remedy		n. 补救；治疗；赔偿;vt. 补救；治疗；纠正
remember		vi. 记得，记起;vt. 记得；牢记；纪念；代…问好
Remote		n. 远程;adj. 遥远的；偏僻的；疏远的
Removal		n. 免职；移动；排除；搬迁
Remove		n. 移动；距离；搬家;vt. 移动，迁移；开除；调动;vi. 移动，迁移；搬家
Renewable		n. 再生性能源;adj. 可再生的；可更新的；可继续的
Rent		n. 租金;n. (Rent)人名；(瑞典)伦特;vt. 出租；租用；租借;vi. 租；出租
Repair		n. 修理，修补；修补部位;vt. 修理；恢复；补救，纠正;vi. 修理；修复
repeat		n. 重复；副本;vi. 重做；重复发生;vt. 重复；复制；背诵
repeatedly		adv. 反复地；再三地；屡次地
replace		vt. 取代，代替；替换，更换；归还，偿还；把…放回原处
replicate		n. 复制品；八音阶间隔的反覆音;vt. 复制；折叠;adj. 复制的；折叠的;vi. 重复；折转
report		n. 报告；报道；成绩单;vt. 报告；报导；使报到;vi. 报告；报到；写报导;n. (Report)人名；(匈)雷波特
represent		vt. 代表；表现；描绘；回忆；再赠送;vi. 代表；提出异议
representation		n. 代表；表现；表示法；陈述
representative		n. 代表；典型；众议员;adj. 典型的，有代表性的；代议制的
reproduce		vt. 复制；再生；生殖；使…在脑海中重现;vi. 复制；繁殖
reproduction		n. 繁殖，生殖；复制；复制品
reputation		n. 名声，名誉；声望
Require		vt. 需要；要求；命令
requirement		n. 要求；必要条件；必需品
research		n. 研究；调查;vt. 研究；调查;vi. 研究；调查;[ 过去式 researched 过去分词 researched 现在分词 researching ]
resemble		vt. 类似，像
reservation		n. 预约，预订；保留
Reserve		n. 储备，储存；自然保护区；预备队；[金融] 储备金;n. (Reserve)人名；(法)勒塞尔夫;vt. 储备；保留；预约;vi. 预订
resist		n. [助剂] 抗蚀剂；防染剂;vt. 抵抗；忍耐，忍住;vi. 抵抗，抗拒；忍耐
resistance		n. 阻力；电阻；抵抗；反抗；抵抗力
resolution		n. [物] 分辨率；决议；解决；决心
Resolve		n. 坚决；决定要做的事;vt. 决定；溶解；使…分解；决心要做…;vi. 解决；决心；分解
resource		n. 资源，财力；办法；智谋
respect		n. 尊敬，尊重；方面；敬意;vt. 尊敬，尊重；遵守
respectively		adv. 分别地；各自地，独自地
respond		n. 应答；唱和;vi. 回答；作出反应；承担责任;vt. 以…回答
response		n. 响应；反应；回答
responsibility		n. 责任，职责；义务
responsible		adj. 负责的，可靠的；有责任的
Rest		n. 休息，静止；休息时间；剩余部分；支架;n. (Rest)人名；(英、德、俄、捷、荷)雷斯特;vt. 使休息，使轻松；把…寄托于;vi. 休息；静止；依赖；安置
Restrict		vt. 限制；约束；限定
restriction		n. 限制；约束；束缚
Result		n. 结果；成绩；答案；比赛结果;vi. 结果；导致；产生
retain		vt. 保持；雇；记住
Return		n. 返回；归还；回球;adj. 报答的；回程的；返回的;vt. 返回；报答;vi. 返回；报答
Reveal		n. 揭露；暴露；门侧，窗侧;vt. 显示；透露；揭露；泄露
Review		n. 回顾；复习；评论；检讨；检阅;vt. 回顾；检查；复审;vi. 回顾；复习功课；写评论
Revival		n. 复兴；复活；苏醒；恢复精神；再生效
revolution		n. 革命；旋转；运行；循环
revolutionary		n. 革命者;adj. 革命的；旋转的；大变革的
Reward		n. [劳经] 报酬；报答；酬谢;vt. [劳经] 奖励；奖赏
rise		n. 上升；高地；增加；出现;vt. 使…飞起；使…浮上水面;vi. 上升；增强；起立；高耸
risk		n. 风险；危险；冒险;vt. 冒…的危险;n. (Risk)人名；(英、阿拉伯)里斯克
Robust		adj. 强健的；健康的；粗野的；粗鲁的
Role		n. 角色；任务;n. (Role)人名；(意、塞、赤几)罗莱
Root		n. 根；根源；词根；祖先;n. (Root)人名；(英)鲁特；(德、瑞典)罗特;vt. 生根，固定；根源在于;vi. 生根；根除
Roughly		adv. 粗糙地；概略地
routine		n. [计] 程序；日常工作；例行公事;adj. 日常的；例行的
Rule		n. 统治；规则;n. (Rule)人名；(英)鲁尔；(塞)鲁莱;vt. 统治；规定；管理；裁决；支配;vi. 统治；管辖；裁定
run-off		n. 流量，溢流；决赛，决胜选举；溢放口
Rural		adj. 农村的，乡下的；田园的，有乡村风味的
Sacrifice		n. 牺牲；祭品；供奉;vt. 牺牲；献祭；亏本出售;vi. 献祭；奉献
Salary		n. 薪水;vt. 给...加薪；给...薪水
Sample		n. 样品；样本；例子;n. (Sample)人名；(英)桑普尔;adj. 试样的，样品的；作为例子的;vt. 取样；尝试；抽样检查
satisfactory		adj. 满意的；符合要求的；赎罪的
Satisfied		adj. 感到满意的;v. 使满意（satisfy的过去式）
save		prep. 除...之外;n. 救球，救援;vi. 节省；挽救；救球;vt. 节省；保存；储蓄；解救;n. (Save)人名；(法)萨夫；(意、保、西、罗、塞、瑞典)萨薇 (女名)，萨韦
Scale		n. 规模；比例；鳞；刻度；天平；数值范围;n. (Scale)人名；(意)斯卡莱;vt. 测量；攀登；刮鳞；依比例决定;vi. 衡量；攀登；剥落；生水垢
Scan		n. 扫描；浏览；审视；细看;vt. 扫描；浏览；细看；详细调查；标出格律;vi. 扫描；扫掠
Scarce		adj. 缺乏的，不足的；稀有的;adv. 仅仅；几乎不；几乎没有
Skeptical		adj. 怀疑的；怀疑论的，不可知论的
Schedule		n. 时间表；计划表；一览表;vt. 安排，计划；编制目录；将……列入计划表
Scheme		n. 计划；组合；体制；诡计;n. (Scheme)人名；(瑞典)谢默;vt. 计划；策划;vi. 搞阴谋；拟订计划
Scholar		n. 学者；奖学金获得者
Science		n. 科学；技术；学科；理科;n. (Science)人名；(英)赛恩斯
scientific		adj. 科学的，系统的
Scientist		n. 科学家
scope		n. 范围；余地；视野；眼界；导弹射程;vt. 审视
score		n. 分数；二十；配乐；刻痕;vt. 获得；评价；划线，刻划；把…记下;vi. 得分；记分；刻痕;n. (Score)人名；(英)斯科尔
search		n. 搜寻；探究，查究;vt. 搜索；搜寻；调查；搜查；探求;vi. 搜寻；调查；探求;n. (Search)人名；(英)瑟奇
season		n. 时期；季节；赛季;vt. 给…调味；使适应;vi. 变得成熟；变干燥
secondary		n. 副手；代理人;adj. 第二的；中等的；次要的；中级的
second-hand		adj. 旧的，二手的;adv. 间接地，第二手地
section		n. 截面；部分；部门；地区；章节;vt. 把…分段；将…切片；对…进行划分;vi. 被切割成片；被分成部分
secure		vt. 保护；弄到；招致；缚住;adj. 安全的；无虑的；有把握的；稳当的;vi. 获得安全；船抛锚；停止工作
seek		vt. 寻求；寻找；探索；搜索;vi. 寻找；探索；搜索
seemingly		adv. 看来似乎；表面上看来
select		n. 被挑选者；精萃;adj. 精选的；挑选出来的；极好的;vt. 挑选；选拔;vi. 挑选
selection		n. 选择，挑选；选集；精选品
selective		adj. 选择性的;讲究的;有选择地;有选择性地;仔细挑选地
semi		n. 半挂车；半独立式的住宅;n. (Semi)人名；(意、芬)塞米
sense		n. 感觉，官能；观念；道理；理智;vt. 感觉到；检测;n. (Sense)人名；(英)森斯
sensible		n. 可感觉到的东西；敏感的人;adj. 明智的；明显的；意识到的；通晓事理的
sensitive		adj. 敏感的；感觉的；[仪] 灵敏的；感光的；易受伤害的；易受影响的;n. 敏感的人；有灵异能力的人
separate		n. .分开；抽印本;adj. 单独的；分开的；不同的；各自的；;vt. 使分离；使分开；使分居;vi. 分开；隔开；分居
Series		n. 系列，连续；[电] 串联；级数；丛书
Serious		adj. 严肃的，严重的；认真的；庄重的；危急的
Serve		n. 发球，轮到发球;n. (Serve)人名；(法)塞尔夫;vt. 招待，供应；为…服务；对…有用；可作…用;vi. 服役，服务；适合，足够；发球；招待，侍候
service		n. 服务，服侍；服役；仪式;adj. 服务性的；耐用的；服现役的;vt. 维修，检修；保养;n. (Service)人名；(英)瑟维斯
set up		v. 建立；装配；开业；竖立
setting		n. 环境；安装；布置；[天] 沉落;v. 放置；沉没；使…处于某位置（set的ing形式）
Settle		n. 有背长椅;n. (Settle)人名；(英)塞特尔;vt. 解决；安排；使…定居;vi. 解决；定居；沉淀；下陷
several		adj. 几个的；各自的;pron. 几个；数个
Severe		adj. 严峻的；严厉的；剧烈的；苛刻的
severely		adv. 严重地；严格地，严厉地；纯朴地
severity		n. 严重；严格；猛烈
Shade		n. 树荫；阴影；阴凉处；遮阳物；（照片等的）明暗度；少量、些微；细微的差别;n. (Shade)人名；(英、德)谢德;vt. 使阴暗；使渐变；为…遮阳；使阴郁；掩盖;vi. （颜色、色彩等）渐变
Shadow		n. 阴影；影子；幽灵；庇护；隐蔽处;adj. 影子内阁的;vt. 遮蔽；使朦胧；尾随；预示;vi. 渐变；变阴暗
Shake		n. 摇动；哆嗦;vt. 动摇；摇动；震动;vi. 动摇；摇动；发抖;n. (Shake)人名；(英)谢克；(日)社家(姓)
shallow		n. [地理] 浅滩;adj. 浅的；肤浅的;vt. 使变浅;vi. 变浅;n. (Shallow)人名；(英)沙洛
Shame		n. 羞耻，羞愧；憾事，带来耻辱的人;n. (Shame)人名；(科特)沙梅;vt. 使丢脸，使羞愧
Shape		n. 形状；模型；身材；具体化;n. (Shape)人名；(瑞典)沙佩;vt. 形成；塑造，使成形；使符合;vi. 形成；成形；成长
Share		n. 份额；股份;n. (Share)人名；(阿拉伯)沙雷;vt. 分享，分担；分配;vi. 共享；分担
Shift		n. 移动；变化；手段；轮班;vt. 转移；改变；替换;vi. 移动；转变；转换
shifting		n. [计] 移位；狡猾;v. 改变（shift的ing形式）;adj. 移动的；狡诈的
Show		n. 显示；表演；炫耀;n. (Show)人名；(中)邵(普通话·威妥玛)；(英)肖;vt. 显示；说明；演出；展出;vi. 显示；说明；指示
Shrink		vi. 收缩；畏缩;vt. 使缩小，使收缩;n. 收缩
Sight		n. 视力；景象；眼界；见解;adj. 见票即付的；即席的;vt. 看见；瞄准;vi. 瞄准；观看
Sign		n. 迹象；符号；记号；手势;vt. 签署；示意;vi. 签署；签名
Signal		n. 信号；暗号；导火线;n. (Signal)人名；(瑞典)西格纳尔;adj. 显著的；作为信号的;vt. 标志；用信号通知;vi. 发信号
Significance		n. 意义；重要性；意思
Significant		n. 象征；有意义的事物;adj. 重大的；有效的；有意义的；值得注意的；意味深长的
Signify		vt. 表示；意味；预示;vi. 有重要性；要紧；冒充内行
similar		n. 类似物;adj. 相似的
Similarly		adv. 同样地；类似于
Simply		adv. 简单地；仅仅；简直；朴素地；坦白地
simulation		n. 仿真；模拟；模仿；假装
Single		n. 一个；单打；单程票;adj. 单一的；单身的；单程的;vt. 选出;vi. 击出一垒安打
Situation		n. 情况；形势；处境；位置
Skill		n. 技能，技巧；本领，技术;n. (Skill)人名；(瑞典)希尔
Slave		n. 奴隶；从动装置;n. (Slave)人名；(塞、罗)斯拉韦;vi. 苦干；拼命工作
Slight		n. 怠慢；轻蔑;adj. 轻微的，少量的；脆弱的；细长的；不重要的;vt. 轻视，忽略；怠慢
Slightly		adv. 些微地，轻微地；纤细地
Slowly		adv. 缓慢地，慢慢地
small-scale		adj. 小规模的
Smooth		n. 平滑部分；一块平地;adj. 顺利的；光滑的；平稳的;vt. 使光滑；消除（障碍等）；使优雅；缓和;adv. 光滑地；平稳地；流畅地;vi. 变平静；变平滑
Soar		n. 高飞；高涨;n. (Soar)人名；(英、葡)索尔;vi. 高飞；高耸；往上飞舞
so-called		adj. 所谓的；号称的
Social		n. 联谊会；联欢会;adj. 社会的，社交的；群居的
society		n. 社会；交往；社团；社交界
Soft		n. 柔性；柔软的东西；柔软部分;adj. 软的，柔软的；温柔的，温和的；软弱的；笨的;adv. 柔软地；温和地
Soften		vt. 使温和；使缓和；使变柔软;vi. 减轻；变柔和；变柔软
software		n. 软件
solar		n. 日光浴室;adj. 太阳的；日光的；利用太阳光的；与太阳相关的;n. (Solar)人名；(法、英、意、西、塞、捷)索拉尔
solid		n. 固体；立方体;adj. 固体的；可靠的；立体的；结实的；一致的;n. (Solid)人名；(瑞典)索利德
solution		n. 解决方案；溶液；溶解；解答
solve		vt. 解决；解答；溶解;vi. 作解答
sophisticated		adj. 复杂的；精致的；久经世故的；富有经验的;v. 使变得世故；使迷惑；篡改（sophisticate的过去分词形式）
sort		n. 种类；方式；品质;vt. 将…分类；将…排序；挑选出某物;vi. 分类；协调；交往
source		n. 来源；水源；原始资料;n. (Source)人名；(法)苏尔斯
space		n. 空间；太空；距离;vt. 隔开;vi. 留间隔
spacious		adj. 宽敞的，广阔的；无边无际的
span		n. 跨度，跨距；范围;vt. 跨越；持续；以手指测量;n. (Span)人名；(捷)斯潘
special		n. 特使，特派人员；特刊；特色菜；专车；特价商品;adj. 特别的；专门的，专用的
specialist		n. 专家；专门医师;adj. 专家的；专业的
species		n. [生物] 物种；种类;adj. 物种上的
specific		n. 特性；细节；特效药;adj. 特殊的，特定的；明确的；详细的；[药] 具有特效的
specifically		adv. 特别地；明确地
Spectrum		n. 光谱；频谱；范围；余象
speed		n. 速度，速率；迅速，快速；昌盛，繁荣;vt. 加快…的速度；使成功，使繁荣;vi. 超速，加速；加速，迅速前行；兴隆;n. (Speed)人名；(英)斯皮德
Spin		n. 旋转；疾驰;vt. 使旋转；纺纱；编造；结网;vi. 旋转；纺纱；吐丝；晕眩
Spot		n. 地点；斑点;adj. 现场的；现货买卖的;vt. 认出；弄脏；用灯光照射;adv. 准确地；恰好;vi. 沾上污渍；满是斑点
Sprawl		n. 蔓生；伸开手足躺卧姿势;vt. 懒散地伸开；使蔓生;vi. 蔓延；伸开手足躺；无计划地扩展
Spread		n. 传播；伸展;adj. 伸展的;vt. 传播，散布；展开；伸展；铺开;vi. 传播；伸展
Stability		n. 稳定性；坚定，恒心
Stable		n. 马厩；牛棚;n. (Stable)人名；(英)斯特布尔;adj. 稳定的；牢固的；坚定的;vt. 赶入马房;vi. 被关在马厩
staff		n. 职员；参谋；棒；支撑;adj. 职员的；行政工作的;vt. 供给人员；给…配备职员;vi. 雇用工作人员;n. (Staff)人名；(德、匈)施塔夫；(瑞典、英)斯塔夫
Stage		n. 阶段；舞台；戏剧；驿站;n. (Stage)人名；(英)斯特奇;vt. 举行；上演；筹划;vi. 举行；适于上演；乘驿车旅行
standard		n. 标准；水准；旗；度量衡标准;adj. 标准的；合规格的；公认为优秀的;n. (Standard)人名；(英)斯坦达德；(德)施坦达德
startling		adj. 令人吃惊的
Starve		vt. 使饿死；使挨饿;vi. 饿死；挨饿；渴望
statement		n. 声明；陈述，叙述；报表，清单
stationary		n. 不动的人；驻军;adj. 固定的；静止的；定居的；常备军的
Stay		n. 逗留；停止；支柱;vt. 坚持；暂住；抑制;vi. 停留；坚持；暂住；停下
steadily		adv. 稳定地；稳固地；有规则地
Steady		n. 关系固定的情侣；固定支架;adj. 稳定的；不变的；沉着的;vt. 使稳定；稳固；使坚定;adv. 稳定地；稳固地;vi. 稳固
stimulate		vi. 起刺激作用；起促进作用;vt. 刺激；鼓舞，激励
stimulation		n. 刺激；激励，鼓舞
stimulus		n. 刺激；激励；刺激物
storage		n. 存储；仓库；贮藏所
Store		n. 商店；储备，贮藏；仓库;n. (Store)人名；(德)施托雷;vt. 贮藏，储存
Storey		n. [建] 楼层；叠架的一层;n. (Storey)人名；(西、瑞典)斯托雷；(英)斯托里
Storm		n. 暴风雨；大动荡;n. (Storm)人名；(瑞典)斯托姆；(德)施托姆；(英、西、芬)斯托姆;vt. 猛攻；怒骂;vi. 起风暴；横冲直撞；狂怒咆哮
straight		n. 直；直线;adj. 直的；连续的；笔直的；正直的；整齐的;adv. 直接地；不断地；立即；坦率地;n. (Straight)人名；(英)斯特雷特
strategy		n. 战略，策略
strength		n. 力量；力气；兵力；长处
strengthen		vt. 加强；巩固;vi. 变强；变坚挺
Stress		n. 压力；强调；紧张；重要性；重读;n. (Stress)人名；(意)斯特雷斯;vt. 强调；使紧张；加压力于；用重音读
Strike		n. 罢工；打击；殴打;n. (Strike)人名；(英)斯特赖克;vt. 打，击；罢工；撞击，冲击；侵袭；打动；到达;vi. 打，打击；罢工；敲，敲击；抓；打动；穿透
structure		n. 结构；构造；建筑物;vt. 组织；构成；建造
struggle		n. 努力，奋斗；竞争;vt. 使劲移动；尽力使得;vi. 奋斗，努力；挣扎
Style		n. 风格；时尚；类型；字体;n. (Style)人名；(英)斯泰尔;vt. 设计；称呼；使合潮流;vi. 设计式样；用刻刀作装饰画
subdivide		vt. 把……再分，把……细分;vi. 细分，再分
subject		n. 主题；科目；[语] 主语；国民;adj. 服从的；易患…的；受制于…的;vt. 使…隶属；使屈从于…
subjective		adj. 主观的；个人的；自觉的
substance		n. 物质；实质；资产；主旨
substantial		n. 本质；重要材料;adj. 大量的；实质的；内容充实的
substitute		n. 代用品；代替者;vi. 替代;vt. 代替
succeed		vi. 成功；继承；继任；兴旺;vt. 继承；接替；继…之后
Success		n. 成功，成就；胜利；大获成功的人或事物
successful		adj. 成功的；一帆风顺的
Successive		adj. 连续的；继承的；依次的；接替的
Sudden		n. 突然发生的事;adj. 突然的，意外的；快速的
Suffer		n. (Suffer)人名；(意)苏费尔;vt. 遭受；忍受；经历;vi. 遭受，忍受；受痛苦；经验；受损害
Sufficient		adj. 足够的；充分的
Suggest		vt. 提议，建议；启发；使人想起
suicide		n. 自杀；自杀行为；自杀者;adj. 自杀的;vt. 自杀;vi. 自杀
suit		n. 诉讼；组；套装；恳求;vt. 适合；使适应;vi. 合适；相称
suitable		adj. 适当的；相配的
Sum		n. 金额；总数;n. (Sum)人名；(英)萨姆；(柬)孙；(俄、德、捷)苏姆；(越)森;vt. 总结；合计;vi. 概括
Supervision		n. 监督，管理
supplement		vt. 增补，补充;n. 增补，补充；补充物；增刊，副刊
supply		n. 供给，补给；供应品;vt. 供给，提供；补充;vi. 供给；替代
Support		n. 支持，维持；支援，供养；支持者，支撑物;vt. 支持，支撑，支援；扶持，帮助；赡养，供养
Suppose		conj. 假使…结果会怎样;vt. 假设；认为；让（虚拟语气）；推想;vi. 猜想；料想
Surface		n. 表面；表层；外观;n. (Surface)人名；(英)瑟菲斯;adj. 表面的，肤浅的;vt. 使浮出水面；使成平面;vi. 浮出水面
Surge		n. 大浪；汹涌澎湃；巨涌;vi. 激增；汹涌;vt. 使颠簸
Surprise		n. 惊奇，诧异；突然袭击;adj. 令人惊讶的;vt. 使惊奇；奇袭
Surprising		adj. 令人惊讶的；意外的;v. 使惊奇；意外发现（surprise的ing形式）
Surround		n. 围绕物;adj. 环绕立体声的;vt. 围绕；包围
Surrounding		n. 环境，周围的事物;adj. 周围的，附近的
survey		n. 调查；测量；审视；纵览;vt. 调查；勘测；俯瞰;vi. 测量土地
Survival		n. 幸存，残存；幸存者，残存物
survive		vi. 幸存；活下来;vt. 幸存；生还；幸免于；比...活得长
Suspect		n. 嫌疑犯;adj. 可疑的；不可信的;vt. 怀疑；猜想;vi. 怀疑；猜想
Suspend		vt. 延缓，推迟；使暂停；使悬浮;vi. 悬浮；禁赛
Sustain		vt. 维持；支撑，承担；忍受；供养；证实
sustainable		adj. 可以忍受的；足可支撑的；养得起的；可持续的
Sway		n. 影响；摇摆；统治;n. (Sway)人名；(以)斯韦;vt. 影响；统治；使摇动;vi. 影响；摇摆
Sweep		n. 打扫，扫除；范围；全胜;vt. 扫除；猛拉；掸去;vi. 扫，打扫；席卷；扫视；袭击
Swiftly		adv. 很快地；敏捷地；即刻
Symbol		n. 象征；符号；标志
sympathetic		n. 交感神经；容易感受的人;adj. 同情的；交感神经的；共鸣的；赞同的；和谐的；合意的
System		n. 制度，体制；系统；方法
systematic		adj. 系统的；体系的；有系统的；[图情] 分类的；一贯的，惯常的
systematically		adv. 有系统地；有组织地
Tackle		n. 滑车；装备；用具；扭倒;vt. 处理；抓住；固定；与…交涉;vi. 扭倒；拦截抢球
take place		发生；举行
take up		拿起；开始从事；占据(时间,地方)
Talent		n. 才能；天才；天资
Target		n. 目标；靶子;n. (Target)人名；(法)塔尔热；(英)塔吉特;vt. 把……作为目标；规定……的指标；瞄准某物
Task		n. 工作，作业；任务;vt. 分派任务
technical		adj. 工艺的，科技的；技术上的；专门的
technique		n. 技巧，技术；手法
technology		n. 技术；工艺；术语
temperature		n. 温度;量某人的体温;发烧;氛围;体温
Tend		vt. 照料，照管;vi. 趋向，倾向；照料，照顾
tendency		n. 倾向，趋势；癖好
tenfold		n. 十倍;adj. 十倍的；十重的;adv. 十倍地；成十倍
tension		n. 张力，拉力；紧张，不安；电压;vt. 使紧张；使拉紧
Term		n. 术语；学期；期限；条款;n. (Term)人名；(泰)丁;vt. 把…叫做
Thanks to		由于，幸亏
theoretical		adj. 理论的；理论上的；假设的；推理的
Theory		n. 理论；原理；学说；推测
Therapy		n. 治疗，疗法
therefore		adv. 因此；所以
Thoroughly		adv. 彻底地，完全地
Thought		n. 思想；思考；想法；关心;v. 想，思考；认为（think的过去式和过去分词）
Threat		n. 威胁，恐吓；凶兆
Threaten		vt. 威胁；恐吓；预示;vi. 威胁；可能来临
Thrive		vi. 繁荣，兴旺；茁壮成长
through		prep. 通过；穿过；凭借;adj. 直达的；过境的；完结的;adv. 彻底；从头至尾
Throughout		prep. 贯穿，遍及;adv. 自始至终，到处；全部
time-consuming		adj. 耗时的；旷日持久的
Tiny		n. (Tiny)人名；(葡、印)蒂尼;adj. 微小的；很少的
Tolerant		adj. 宽容的；容忍的；有耐药力的
Tool		n. 工具，用具；器械，机床；手段;vt. 用工具给……加工;vi. 使用工具；用机床装备工厂
Tooth		n. 牙齿;n. (Tooth)人名；(英)图思;vt. 给……装齿;vi. 啮合
topic		n. 主题（等于theme）；题目；一般规则；总论
Totally		adv. 完全地
Touch		n. 接触；触觉；格调；少许;n. (Touch)人名；(柬)杜；(英)陶奇;vt. 接触；触动；使轻度受害;vi. 触摸；涉及；接近；提到
Tour		n. 旅游，旅行；巡回演出;n. (Tour)人名；(瑞典)托尔；(英)图尔;vt. 旅行，在……旅游；在……作巡回演出;vi. 旅行，旅游；作巡回演出
Tourism		n. 旅游业；游览
Tourist		n. 旅行者，观光客;adj. 旅游的;vt. 在旅行参观;adv. 坐旅游车厢；坐经济舱;vi. 旅游；观光
Track		n. 轨道；足迹，踪迹；小道;vt. 追踪；通过；循路而行；用纤拉;vi. 追踪；走；留下足迹
Trade		n. 贸易，交易；行业；职业;vt. 用…进行交换;vi. 交易，买卖；以物易物
tradition		n. 惯例，传统；传说
traditional		adj. 传统的；惯例的
Train		n. 火车；行列；长队；裙裾;n. (Train)人名；(英)特雷恩；(法)特兰；(意)特拉因;v. 培养；训练；瞄准
transfer		n. 转让；转移；传递；过户;vt. 使转移；调任;vi. 转让；转学；换车
transform		vt. 改变，使…变形；转换;vi. 变换，改变；转化
translate		vt. 翻译；转化；解释；转变为；调动;vi. 翻译
transmit		vt. 传输；传播；发射；传达；遗传;vi. 传输；发射信号
transport		n. 运输；运输机；狂喜；流放犯;vt. 运输；流放；使狂喜
Trap		n. 陷阱；圈套；[建] 存水弯;n. (Trap)人名；(英)特拉普;vt. 诱捕；使…受限制；使…陷入困境;vi. 设陷阱
treasure		n. 财富，财产；财宝；珍品;vt. 珍爱；珍藏;n. (Treasure)人名；(英)特雷热
Treat		n. 请客；款待;n. (Treat)人名；(英)特里特;vt. 治疗；对待；探讨；视为;vi. 探讨；请客；协商
treatment		n. 治疗，疗法；处理；对待
tremendous		adj. 极大的，巨大的；惊人的
Trend		n. 趋势，倾向；走向;n. (Trend)人名；(英)特伦德;vt. 使…趋向;vi. 趋向，伸向
Trial		n. 试验；审讯；努力；磨炼;n. (Trial)人名；(法)特里亚尔;adj. 试验的；审讯的
Trigger		n. 扳机；[电子] 触发器；制滑机;n. (Trigger)人名；(英)特里杰;vt. 引发，引起；触发;vi. 松开扳柄
Tropical		adj. 热带的；热情的；酷热的
troublesome		adj. 麻烦的；讨厌的；使人苦恼的
Trust		n. 信任，信赖；责任；托拉斯;n. (Trust)人名；(英)特拉斯特;vt. 信任，信赖；盼望；赊卖给;vi. 信任，信赖；依靠
Truth		n. 真理；事实；诚实；实质
Tuition		n. 学费；讲授
Type		n. 类型，品种；模范；样式;n. (Type)人名；(英)泰普;vt. 打字；测定（血等）类型;vi. 打字
typical		adj. 典型的；特有的；象征性的
typically		adv. 代表性地；作为特色地
ultimate		n. 终极；根本；基本原则;adj. 最终的；极限的；根本的
ultimately		adv. 最后；根本；基本上
unavoidable		adj. 不可避免的；不能废除的
unbiased		adj. 公正的；无偏见的
undergraduate		n. 大学生；大学肄业生;adj. 大学生的
undermine		vt. 破坏，渐渐破坏；挖掘地基
understand		vi. 理解；懂得；熟悉;vt. 理解；懂；获悉；推断；省略
unemployment		n. 失业；失业率；失业人数
unexpected		adj. 意外的，想不到的
unexpectedly		adv. 出乎意料地，意外地
Unfair		adj. 不公平的，不公正的
unfamiliar		adj. 不熟悉的；不常见的；没有经验的
uniform		n. 制服;adj. 统一的；一致的；相同的；均衡的；始终如一的;vt. 使穿制服；使成一样
Unique		n. 独一无二的人或物;n. (Unique)人名；(英)尤妮克;adj. 独特的，稀罕的；[数] 唯一的，独一无二的
universally		adv. 普遍地；人人；到处
Unlike		prep. 和…不同，不像;adj. 不同的，不相似的
unlikely		adj. 不太可能的；没希望的;adv. 未必
unnecessary		adj. 不必要的；多余的，无用的
unorthodox		adj. 非正统的；异端的；异教的
Unpleasant		adj. 讨厌的；使人不愉快的
Unpopular		adj. 不流行的，不受欢迎的
unpredictable		n. 不可预言的事;adj. 不可预知的；不定的；出乎意料的
unusual		adj. 不寻常的；与众不同的；不平常的
Update		n. 更新；现代化;vt. 更新；校正，修正；使现代化
urban		adj. 城市的；住在都市的;n. (Urban)人名；(西)乌尔万；(斯洛伐)乌尔班；(德、俄、罗、匈、塞、波、捷、瑞典、意)乌尔班；(英)厄本；(法)于尔邦
urgent		adj. 紧急的；急迫的
usage		n. 使用；用法；惯例
useful		adj. 有用的，有益的；有帮助的
useless		adj. 无用的；无效的
usual		adj. 通常的，惯例的；平常的
valuable		n. 贵重物品;adj. 有价值的；贵重的；可估价的
value		n. 值；价值；价格；重要性；确切涵义;vt. 评价；重视；估价
vanish		n. 弱化音;vi. 消失；突然不见；成为零;vt. 使不见，使消失
variable		n. [数] 变量；可变物，可变因素;adj. 变量的；可变的；易变的，多变的；变异的，[生物] 畸变的
variation		n. 变化；[生物] 变异，变种
variety		n. 多样；种类；杂耍；变化，多样化
various		adj. 各种各样的；多方面的
vary		vi. 变化；变异；违反;vt. 改变；使多样化；变奏;n. (Vary)人名；(英、法、罗、柬)瓦里
vast		n. 浩瀚；广阔无垠的空间;adj. 广阔的；巨大的；大量的；巨额的;n. (Vast)人名；(法)瓦斯特
vehicle		n. [车辆] 车辆；工具；交通工具；运载工具；传播媒介；媒介物
verbal		n. 动词的非谓语形式;adj. 口头的；言语的；动词的；照字面的
Victim		n. 受害人；牺牲品；牺牲者
view		n. 观察；视野；意见；风景;vt. 观察；考虑；查看
violence		n. 暴力；侵犯；激烈；歪曲
Violent		adj. 暴力的；猛烈的
virtually		adv. 事实上，几乎；实质上
Visit		n. 访问；参观；逗留;n. (Visit)人名；(老)维西；(泰)威实;vt. 访问；参观；视察;vi. 访问；暂住；闲谈
Visual		adj. 视觉的，视力的；栩栩如生的
Vital		n. (Vital)人名；(法、德、意、俄、葡)维塔尔；(西)比塔尔;adj. 至关重要的；生死攸关的；有活力的
Vivid		adj. 生动的；鲜明的；鲜艳的
vocabulary		n. 词汇；词表
voluntary		n. 志愿者；自愿行动;adj. 自愿的；志愿的；自发的；故意的
volunteer		n. 志愿者；志愿兵;adj. 志愿的;vt. 自愿;vi. 自愿
vulnerable		adj. 易受攻击的，易受…的攻击；易受伤害的；有弱点的
Warming		n. 加温，暖和；气温升高;n. (Warming)人名；(丹、瑞典)瓦明;adj. 让人感到暖和的;v. 加温；兴奋；同情（warm的ing形式）
Warn		n. (Warn)人名；(英)沃恩；(德)瓦恩;vt. 警告，提醒；通知;vi. 发出警告，发出预告
Warning		n. 警告；预兆；预告;n. (Warning)人名；(德)瓦宁;adj. 警告的；引以为戒的;v. 警告（warn的ing形式）
Waste		n. 浪费；废物；荒地；损耗；地面风化物;adj. 废弃的；多余的；荒芜的;vt. 浪费；消耗；使荒芜;vi. 浪费；变消瘦；挥霍钱财
Wave		n. 波动；波浪；高潮；挥手示意；卷曲;vt. 卷（烫）发；向…挥手示意；使成波浪形;vi. 波动；起伏；挥手示意；摇动；呈波形
Wavy		adj. 多浪的；波动起伏的
weakness		n. 弱点；软弱；嗜好
Wealth		n. 财富；大量；富有
Wealthy		n. 富人;adj. 富有的；充分的；丰裕的
Weapon		n. 武器，兵器
Weight		n. 重量，重力；负担；砝码；重要性;n. (Weight)人名；(英)韦特；(捷)魏格特;vt. 加重量于，使变重
Weird		n. （苏格兰）命运；预言;adj. 怪异的；不可思议的；超自然的
well known		众所周知的；出名的
Wet		n. 雨天；湿气;n. (Wet)人名；(英、纳米、南非)韦特;adj. [气象][物] 潮湿的；有雨的;vt. 弄湿;vi. 变湿
Wheel		n. 车轮；方向盘；转动;vt. 转动；使变换方向；给…装轮子;vi. 旋转；突然转变方向；盘旋飞行
whereas		conj. 然而；鉴于；反之
whether		conj. 是否；不论;pron. 两个中的哪一个
while		conj. 虽然；然而；当……的时候;n. 一会儿；一段时间;vt. 消磨；轻松地度过
whole		n. 整体；全部;adj. 完整的；纯粹的
wide		n. 大千世界;adj. 广泛的；宽的，广阔的；张大的；远离目标的;adv. 广泛地；广阔地；充分地;n. (Wide)人名；(瑞典、芬)维德
widen		vt. 放宽;vi. 变宽;n. (Widen)人名；(德)维登
widespread		adj. 普遍的，广泛的；分布广的
width		n. 宽度；广度
win		n. 赢；胜利;vt. 赢得；在…中获胜；劝诱;vi. 赢；获胜；成功;n. (Win)人名；(德、荷、缅)温；(英)温(女子教名Winifred的昵称)
wisdom		n. 智慧，才智；明智；学识；至理名言;n. (Wisdom)人名；(英)威兹德姆
Withdraw		vt. 撤退；收回；撤消；拉开;vi. 撤退；离开
wonder		n. 惊奇；奇迹；惊愕;adj. 奇妙的；非凡的;vi. 怀疑；想知道；惊讶;vt. 怀疑；惊奇；对…感到惊讶;n. (Wonder)人名；(英)旺德
worksheet		n. 工作表，工作单
worthwhile		adj. 值得做的，值得花时间的
Yield		n. 产量；收益;vt. 屈服；出产；放弃;vi. 屈服，投降
Zone		n. 地带；地区；联防;n. (Zone)人名；(塞)佐内;vt. 使分成地带；环绕;vi. 分成区
